border_size=1
usage=map

Rrc         , Gll^Fp      , Gll^Fp      , Gg          , Gg          , Gg          , Gg          , Gg          , Gg          , Gg          , Gll^Fp      , Gll^Fp      , Gll^Fp      , Gll^Fp      , Gll^Fp      , Gg          , Gg          , Gg          , Gll^Fp      , Gg          , Gll^Fp      , Gg          , Hh^Fms      , Gg          , Hh^Fms      , Gg          , Gg          , Gg          , Gg          , Gg          , Gs^Fms      , Gs^Fms      , Gs^Fms      , Gs^Fms      , Gs^Fms      , Gs^Fms      , Gs^Fms      , Gg          
Gg          , Rrc         , Rrc         , Gg          , Gs          , Gs          , Gg          , Gs^Vc       , Gg          , Gll^Fp      , Gg^Gvs      , Gll^Fp      , Gg^Gvs      , Gg          , Gll^Fp      , Gll^Fp      , Gll^Fp      , Gll^Fp      , Gll^Fp      , Gll^Fp      , Gll^Fp      , Gll^Fp      , Gll^Fp      , Hh^Fms      , Gll^Fp      , Hh^Fms      , Gg          , Gs^Fms      , Gs^Fms      , Gg          , Gs^Fms      , Gs^Fms      , Gs^Fms      , Gs^Fms      , Gg          , Gs^Fms      , Gs^Fms      , Gg          
Gg          , Gg          , Ch          , Rrc         , Ch          , Gg          , Re          , Gg          , Gg^Gvs      , Gg^Gvs      , Gg^Gvs      , Gg^Gvs      , Gg          , Gll^Fp      , Gll^Fp      , Gg          , Gg          , Gg          , Gll^Fp      , Gg          , Gg          , Gg          , Gg          , Gll^Fp      , Gll^Fp      , Gg          , Gg          , Gg          , Gg^Ve       , Gs^Fms      , Gs^Fms      , Gs^Fms      , Gg          , Gg          , Gs^Fms      , Gs^Fms      , Gg          , Gs^Fms      
Gg          , Gg          , Ch          , 1 Kh        , Gg          , Rrc         , Re          , Re          , Re          , Re          , Re          , Gg          , Re          , Gg          , Re          , Gg          , Re          , Gll^Fp      , Gll^Fp      , Gll^Fp      , Rb          , Gg          , Rb          , Gg          , Rb          , Gg          , Gg          , Gg          , Gs^Fms      , Gs^Fms      , Hh^Fms      , Gll^Fp      , Gll^Fp      , Gg          , Gs^Fms      , Gll^Fp      , Gg          , Gs^Fms      
Gg          , Gs^Vl       , Gll^Fp      , Gg          , Gg          , Rrc         , Rrc         , Gs^Vh       , Gg          , Gg          , Gll^Fp      , Re          , Gg          , Re          , Gg          , Re          , Re          , Re          , Re          , Rb          , Gll^Fp      , Rb          , Rd          , Rb          , Gll^Fp      , Rb          , Ce          , Gg          , Gg          , Gll         , Gll^Fp      , Gg^Fet      , Gll^Fp      , Gll^Fp      , Gg          , Gll^Fp      , Gll^Fp      , Gll^Fp      
Hh^Fp       , Gll^Fp      , Gll^Fp      , Gg          , Gg          , Gg          , Rrc         , Rb          , Gg          , Gg          , Gll^Fp      , Gg          , Gg          , Gg          , Gg          , Gg          , Gll^Fp      , Gg          , Gg          , Re          , Re          , Re          , Gll^Fp      , Gll^Fp      , Gs^Vc       , Gll         , Ce          , Ke          , Gll^Fp      , Gll^Fp      , Gg          , Gll^Fp      , Re          , Gg          , Gg          , Gg          , Gll^Fp      , Gll^Fp      
Hh^Fp       , Gll^Fp      , Gll^Fp      , Gll^Fp      , Gg          , Gg          , Rrc         , Rrc         , Gg          , Gg          , Gg          , Gll^Fp      , Gll^Fp      , Gll^Fp      , Gg          , Gll^Fp      , Gs          , Gg          , Gs          , Rb          , Rb          , Gll^Fp      , Gg          , Gll^Fp      , Gg          , Gll         , Gg          , Ce          , Re          , Re          , Re          , Re          , Gll^Fp      , Re          , Re          , Gll^Fp      , Gg          , Gll^Fp      
Hh^Fp       , Hh^Fp       , Hh^Fp       , Gll^Fp      , Gg          , Gg          , Rrc         , Gg          , Gg          , Gll^Fp      , Gll^Fp      , Gll^Fp      , Gg          , Gll^Fp      , Gg          , Gll^Fp      , Gll^Fp      , Gll^Fp      , Gll^Fp      , Gg          , Gg          , Rb          , Rb          , Rb          , Rb          , Gg          , Rb          , Rb          , Gg          , Gg          , Gg^Ve       , Gll^Fp      , Mm          , Gll^Fp      , Gg          , Re          , Re          , Gll^Fp      
Hh^Fp       , Hh^Fp       , Gg^Wm       , Gll^Fp      , Gs          , Gs          , Rrc         , Gg          , Gg          , Gll^Fp      , Gll^Fp      , Gg          , Gg^Efm      , Gg^Efm      , Gg^Efm      , Gg^Ve       , Gs^Fms      , Gg          , Gs^Fms      , Gg          , Gg          , Gg          , Gg          , Rb          , Gg          , Rb          , Gg          , Gg          , Mm          , Hh^Wm       , Mm^Xm       , Mm          , Mm          , Gg          , Gg          , Re          , Gg          , Re          
Hh^Fp       , Gg^Esd      , Gg          , Gg          , Gs          , Gs          , Rrc         , Rb          , Gg^Efm      , Gg          , Gll^Fp      , Gll^Fp      , Gll^Fp      , Gg^Efm      , Gg          , Ds          , Ds          , Gs^Fms      , Ds          , Gs^Fms      , Ds          , Gs^Fms      , Gg          , Gg          , Gg          , Gg          , Gg          , Gg          , Mm          , Mm^Xm       , Gll^Fp      , Mm^Xm       , Hh^Fp       , Hh^Fp       , Re          , Re          , Gg          , Gg          
Gg          , Hh^Fp       , Gg          , Gg          , Gg          , Rb          , Rrc         , Rb          , Rb          , Gg^Efm      , Gg          , Gll^Fp      , Gll^Fp      , Gs^Fms      , Gs^Fms      , Ds          , Ww          , Wwrg        , Ww          , Ds          , Wwf         , Gs^Fms      , Gg          , Gll^Fp      , Gll^Fp      , Gg          , Gg          , Gll^Fp      , Gll^Fp      , Mm          , Hh^Fp       , Gll^Fp      , Gs^Fms      , Hh          , Re          , Re          , Gg          , Gg          
Gg          , Gg^Efm      , Gg          , Gg          , Rrc         , Rrc         , Gs^Fms      , Gg^Fet      , Rb          , Rb          , Gs^Fms      , Gs^Fms      , Wwr         , Wwf         , Ww          , Ww          , Wo          , Ww          , Wo          , Ww          , Ww          , Ds          , Gg          , Gg          , Gll^Fp      , Gll^Fp      , Gll^Fp      , Gll^Fp      , Gll^Fp      , Gg          , Re          , Re          , Re          , Re          , Re          , Gg          , Gs^Fms      , Gg          
Gg^Efm      , Gg^Efm      , Gg^Efm      , Rb          , Rb          , Rrc         , Gs^Vc       , Gs^Fms      , Rb          , Gs^Fms      , Ww          , Ww          , Wo          , Wo          , Wo          , Wo          , Ww          , Ww          , Wo          , Wo          , Ww          , Ww          , Gg          , Gg          , Gll^Fp      , Gg          , Gll^Fp      , Gll^Fp      , Re          , Re          , Gg          , Re          , Gll^Fp      , Gg          , Gg          , Gg          , Gs^Fms      , Gg          
Gg^Efm      , Gg^Efm      , Gg          , Gg          , Re          , Rrc         , Rrc         , Gs^Fms      , Rb          , Ww          , Ww          , Wot         , Ww^Vm       , Wo          , Wo          , Wo          , Wo          , Wo          , Wo          , Wo          , Ww          , Ww          , Gs^Fds      , Gg          , Gll^Fp      , Gg^Ve       , Gll^Fp      , Gll^Fp      , Re          , Re          , Gg          , Gg          , Gg          , Gll^Fp      , Gg          , Gg          , Gll^Fp      , Gg          
Gg          , Gg          , Gs^Fds      , Gg          , Gg          , Re          , Rrc         , Rrc         , Rrc         , Ww          , Wo          , Ww          , Wo          , Ww          , Wo          , Wo          , Ww          , Wo          , Wwrg        , Ww^Vm       , Wwf         , Wwrg        , Gg          , Gg          , Gll^Fp      , Gd          , Gd          , Gg          , Re          , Gg          , Gg          , Gg          , Gg          , Gg          , Ww          , Gs^Fds      , Gll^Fp      , Gs^Fds      
Gg          , Gll^Fp      , Gll^Fp      , Gg          , Gg          , Cha         , Gs          , Rrc         , Gs          , Wo^Bw\      , Wo^Bw\      , Ww          , Cha         , Wwrg        , Chw         , Chw         , Chs         , Wwrg        , Wwrg        , Ss          , Ss          , Gg          , Gg^Efm      , Gg          , Gg          , Gll^Fp      , Gg          , Re          , Gg          , Gg          , Gg          , Gll^Fp      , Gg          , Ww          , Gll^Fp      , Gg^Ve       , Gll^Fp      , Gll^Fp      
Gll^Fp      , Gll^Fp      , Gs^Fds      , Gll^Fp      , Gg          , Gs^Fds      , Gs^Fds      , Gs^Fds      , Gs^Fds      , Wo          , Ww          , Rrc         , Rrc         , Rrc         , Rrc         , 2 Khw       , Ss          , Ss          , Ds          , Ss          , Gll^Fp      , Ss          , Gll^Fp      , Gg^Efm      , Gll^Fp      , Gll^Fp      , Gll^Fp      , Re          , Re          , Gll^Fp      , Gll^Fp      , Gll^Fp      , Gg          , Gll^Fp      , Gll^Fp      , Gll^Fp      , Gg          , Gll^Fp      
Gll^Fp      , Gs          , Gll^Fp      , Gs^Fds      , Gs^Fds      , Gs^Fds      , Ds          , Ds          , Ww          , Wwrg        , Wwrg        , Gs^Fms      , Gs^Fms      , Rrc         , Rb          , Rrc         , Rrc         , Rb          , Gg          , Gll^Fp      , Gll^Fp      , Gll^Fp      , Gll^Fp      , Gg          , Gs          , Gg          , Gs          , Gg          , Re          , Re          , Re          , Gg          , Gg          , Gll^Fp      , Gg          , Gll^Fp      , Gll^Fp      , Gg          
Gg          , Gll^Fp      , Gg          , Gll^Fp      , Gs^Fds      , Gg          , Ds          , Ww          , Gg^Es       , Ww          , Wwrg        , Wwrg        , Mm          , Mm          , Mm          , Rb          , Rrc         , Rrc         , Gg          , Gll^Fp      , Gg          , Gll^Fp      , Gg          , Gll^Fp      , Gg          , Gs          , Gg^Gvs      , Gg^Gvs      , Gg          , Gg          , Gg          , Re          , Re          , Gg          , Gg          , Hh^Fms      , Mm          , Mm          
Gg          , Gg          , Gll^Fp      , Gg          , Gg          , Gg          , Ww          , Ww          , Gg^Efm      , Gs^Fds      , Ww          , Mm          , Mm^Xm       , Mm^Xm       , Hh          , Gg          , Gg          , Rrc         , Rrc         , Gg          , Gg          , Gg          , Gd          , Gd          , Gd          , Gg^Ve       , Gs^Fms      , Gs^Fms      , Gs^Fms      , Gg          , Gg^Gvs      , Gg          , Gg          , Re          , Gg          , Hh^Fms      , Mm          , Mm          
Gg          , Gll^Fp      , Gg          , Gg          , Gg          , Ww          , Ww          , Gs^Fds      , Gs^Efm      , Gg^Efm      , Ww          , Mm^Xm       , Mm^Xm       , Mm^Xm       , Hh^Fms      , Gg          , Gg          , Rb          , Gg          , Rrc         , Rrc         , Rrc         , Rrc         , Gg          , Gg          , Gg          , Gg          , Gs^Fms      , Gg^Gvs      , Gg^Gvs      , Gg^Gvs      , Gg^Gvs      , Re          , Re          , Gg          , Gg          , Hh^Fms      , Mm^Xm       
Gll^Fp      , Gll^Fp      , Gg          , Gg          , Ww          , Ww          , Gs^Fds      , Gs^Efm      , Sm          , Ww          , Gg          , Mm          , Ww          , Mm          , Hh          , Hh          , Hh          , Gg          , Gs^Fms      , Gg          , Gg          , Rrc         , Gg          , Rrc         , Rrc         , Rrc         , Rrc         , Gg          , Rb          , Gg^Gvs      , Rb          , Re          , Rb          , Gg          , Gg          , Gg          , Hh^Vhh      , Mm^Xm       
Gg          , Gll^Fp      , Ww^Vm       , Ww^Bw\r     , Ww^Bw\r     , Ww          , Wwg         , Gs^Efm      , Ww          , Ww          , Ww          , Ww          , Hh^Fms      , Wwrg        , Hh^Fms      , Md          , Hh          , Gg          , Gs^Fms      , Gs^Fms      , Gs^Fms      , Gs^Fms      , Gs^Fms      , Gs^Fms      , Gs^Fms      , Gg          , Rrc         , Rrc         , Hh          , Rb          , Gs^Fms      , Rb          , Gg          , Rb          , Rb          , Rb          , Rb          , Rb          
Gg          , Ww          , Ww          , Ww          , Gs          , Gs          , Wwg         , Wwf^Es      , Ww          , Ww          , Gg          , Hh^Fms      , Gg          , Hh^Fms      , Hh^Fp       , Hh          , Hh          , Gg          , Gg          , Gs^Fms      , Gs^Fms      , Gs^Fms      , Rrc         , Rrc         , Rrc         , Rrc         , Rrc         , Hh          , Md          , Hh          , Gs^Fms      , Gs^Fms      , Ch          , Gg          , Ch          , Gg          , Gg          , Gg          
Ww          , Ww          , Gg          , Ww^Bw/r     , Ww          , Wwg         , Ww          , Ww          , Mm          , Gg          , Hh          , Gg          , Gg          , Hh^Fms      , Hh^Fp       , Hh^Fp       , Rb          , Rb          , Rrc         , Rb          , Rrc         , Gg          , Rrc         , Rrc         , Re          , Re          , Re          , Rrc         , Rrc         , Gll^Fp      , Gs^Fms      , Gg          , Ch          , 4 Kh        , Gg          , Gg          , Gg          , Gg          
Gll^Fp      , Gll^Fp      , Gd          , Gg^Fet      , Ww          , Ww          , Sm^Es       , Sm          , Mm          , Hh          , Gll^Fp      , Gll^Fp      , Gll^Fp      , Hh^Fms      , Gg          , Rrc         , Rrc         , Rrc         , Rb          , Rrc         , Gg          , Rrc         , Gg          , Gg^Wm       , Gg          , Re          , Gg          , Re          , Rrc         , Re          , Gs^Vh       , Gg          , Gg          , Rb          , Gg          , Gg          , Gg          , Gg          
Ww          , Ww          , Ww          , Ww^Bw\r     , Gg          , Ww          , Sm          , Mm          , Mm          , Gll^Fp      , Gg          , Gg^Ve       , Gs^Fms      , Gs^Fms      , Gg          , Rrc         , Rrc         , Rb          , Gg^Efm      , Gg          , Gg          , Hh^Fms      , Hh^Fp       , Hh^Fms      , Hh^Fms      , Hh^Fms      , Gg          , Re          , Rrc         , Rrc         , Rrc         , Rrc         , Rrc         , Rrc         , Rrc         , Gg          , Gg          , Gg          
Gg          , Ww          , Ww          , Hh          , Hh          , Hh          , Mm          , Mm          , Gll^Fp      , Cv          , Gg^Efm      , Gs^Fms      , Gg          , Gg          , Gg          , Rb          , Rrc         , Rb          , Gg^Efm      , Gg^Efm      , Hh^Fms      , Hh^Fms      , Hh^Fp       , Hh^Fp       , Gg          , Gg          , Gg          , Gg          , Re          , Re          , Re          , Rrc         , Gll^Fp      , Rrc         , Gg          , Rrc         , Re          , Gg          
Mm^Xm       , Mm^Xm       , Gll^Fp      , Gll^Fp      , Gll^Fp      , Gll^Fp      , Gll^Fp      , Gs^Fds      , Cv          , 3 Kv        , Gg          , Gs^Fms      , Gg          , Gg          , Rb          , Rrc         , Rb          , Gg          , Gll^Fp      , Gg          , Hh^Fms      , Gg          , Gg          , Hh^Fp       , Hh^Fp       , Gg          , Gg^Gvs      , Gg^Gvs      , Gg^Gvs      , Gg^Gvs      , Gg          , Gg          , Gll^Fp      , Gg          , Gg          , Rrc         , Rrc         , Gg          
Mm^Xm       , Mm^Xm       , Mm^Xm       , Mm^Xm       , Hh          , Gll^Fp      , Gg^Ve       , Gs^Fms      , Gs^Fms      , Cv          , Gll^Fp      , Gd          , Rb          , Rb          , Rrc         , Rrc         , Gll^Fp      , Gll^Fp      , Hh^Fms      , Gll^Fp      , Hh^Fms      , Hh^Fms      , Hh^Fp       , Hh^Fp       , Hh^Fp       , Gg          , Gll^Fp      , Gg^Gvs      , Gs^Efm      , Gll^Fp      , Gll^Fp      , Gll^Fp      , Gll^Fp      , Gll^Fp      , Gg          , Gg          , Rrc         , Gg          
Mm^Xm       , Mm^Xm       , Mm^Xm       , Mm^Xm       , Gll^Fp      , Gs^Fms      , Gs^Fms      , Gd          , Gs^Fms      , Gll^Fp      , Gg          , Gg          , Rrc         , Rrc         , Gg          , Gg          , Hh^Fms      , Gll^Fp      , Gll^Fp      , Hh^Fp       , Hh^Fp       , Hh^Fp       , Gg          , Hh^Fp       , Gg^Es       , Gg          , Gg          , Gll^Fp      , Gs^Fms      , Gll^Fp      , Gll^Fp      , Gs^Fms      , Gll^Fp      , Gg          , Gg          , Gg          , Gg          , Rrc         
Mm^Xm       , Gll^Fp      , Gll^Fp      , Gll^Fp      , Gs          , Gs^Fms      , Gll^Fp      , Gs^Fms      , Gg          , Gg          , Rrc         , Rrc         , Gg          , Gs^Fms      , Gs^Fms      , Gs^Fms      , Gg          , Gg          , Gg          , Hh^Fms      , Gg          , Gg          , Gg          , Gg^Es       , Gg          , Gg          , Gs^Fms      , Gg          , Gll^Fp      , Gs^Fms      , Gll^Fp      , Gll^Fp      , Gll^Fp      , Gll^Fp      , Gg          , Gs^Fms      , Gg          , Rrc         
