border_size=1
usage=map

Xu          , Xu          , Xu          , Xu          , Xu          , Xu          , Xu          , Xu          , Xu          , Xu          , Xu          , Xu          , Xu          , Xu          , Xu          , Xu          , Xu          , Xu          , Xu          , Xu          , Xu          , Xu          , Xu          , Xu          , Xu          , Xu          , Xu          , Xu          , Xu          , Xu          , Xu          , Xu          , Xu          , Xu          , Xu          , Xu          , Xu          , Xu          
Xu          , Xu          , Xu          , Xu          , Xu          , Xu          , Xu          , Xu          , Xu          , Xu          , Xu          , Xu          , Xu          , Xu          , Xu          , Xu          , Xu          , Xu          , Xu          , Xu          , Xu          , Xu          , Xu          , Xu          , Xu          , Xu          , Xu          , Xu          , Xu          , Xu          , Xu          , Xu          , Xu          , Xu          , Xu          , Xu          , Xu          , Xu          
Xu          , Xu          , Xu          , Xu          , Xu          , Xu          , Xu          , Xu          , Xu          , Xu          , Xu          , Xu          , Xu          , Xu          , Xu          , Xu          , Xu          , Xu          , Xu          , Xu          , Xu          , Xu          , Xu          , Xu          , Xu          , Xu          , Xu          , Xu          , Xu          , Xu          , Xu          , Xu          , Xu          , Xu          , Xu          , Xu          , Xu          , Xu          
Xu          , Xu          , Xu          , Xu          , Xu          , Xu          , Xu          , Xu          , Xu          , Xu          , Xu          , Xu          , Xu          , Xu          , Xu          , Xu          , Xu          , Xu          , Xu          , Xu          , Xu          , Xu          , Xu          , Xu          , Xu          , Xu          , Xu          , Xu          , Xu          , Xu          , Xu          , Xu          , Xu          , Xu          , Xu          , Xu          , Xu          , Xu          
Xu          , Xu          , Xu          , Xu          , Xu          , Xu          , Xu          , Xu          , Xu          , Xu          , Xu          , Xu          , Xu          , Xu          , Xu          , Xu          , Xu          , Xu          , Xu          , Xu          , Xu          , Xu          , Xu          , Xu          , Xu          , Xu          , Xu          , Xu          , Xu          , Xu          , Xu          , Xu          , Xu          , Xu          , Xu          , Xu          , Xu          , Xu          
Xu          , Xu          , Xu          , Xu          , Xu          , Xu          , Xu          , Xu          , Xu          , Xu          , Xu          , Xu          , Xu          , Xu          , Xu          , Xu          , Xu          , Xu          , Xu          , Xu          , Xu          , Xu          , Xu          , Xu          , Xu          , Xu          , Xu          , Xu          , Xu          , Xu          , Xu          , Xu          , Xu          , Xu          , Xu          , Xu          , Xu          , Xu          
Xu          , Xu          , Xu          , Xu          , Xu          , Xu          , Xu          , Xu          , Xu          , Xu          , Xu          , Xu          , Xu          , Xu          , Xu          , Xu          , Xu          , Xu          , Xu          , Xu          , Xu          , Xu          , Xu          , Xu          , Xu          , Xu          , Xu          , Xu          , Xu          , Xu          , Xu          , Xu          , Xu          , Xu          , Xu          , Xu          , Xu          , Xu          
Xu          , Xu          , Xu          , Xu          , Xu          , Xu          , Xu          , Xu          , Xu          , Xu          , Xu          , Xu          , Xu          , Xu          , Xu          , Xu          , Xu          , Xu          , Xu          , Xu          , Xu          , Xu          , Xu          , Xu          , Xu          , Xu          , Xu          , Xu          , Xu          , Xu          , Xu          , Xu          , Xu          , Xu          , Urb         , Ur          , Uh          , Uh          
Xu          , Xu          , Xu          , Xu          , Xu          , Xu          , Xu          , Xu          , Xu          , Xu          , Xu          , Xu          , Xu          , Xu          , Xu          , Xu          , Xu          , Xu          , Xu          , Xu          , Xu          , Xu          , Xu          , Xu          , Xu          , Xu          , Xu          , Xu          , Xu          , Xu          , Urb^Em      , Urb         , Urb         , Ur          , Uh          , Xu          , Xu          , Xu          
Xu          , Xu          , Xu          , Xu          , Xu          , Xu          , Xu          , Xu          , Xu          , Xu          , Xu          , Xu          , Xu          , Xu          , Xu          , Xu          , Xu          , Xu          , Xu          , Xu          , Xu          , Xu          , Xu          , Xu          , Xu          , Xu          , Xu          , Xu          , Xu          , Uh^Emf      , Xu          , Xu          , Xu          , Xu          , Xu          , Xu          , Xu          , Xu          
Xu          , Xu          , Xu          , Xu          , Xu          , Xu          , Xu          , Xu          , Xu          , Xu          , Xu          , Xu          , Xu          , Xu          , Xu          , Xu          , Xu          , Xu          , Xu          , Xu          , Xu          , Xu          , Xu          , Xu          , Xu          , Xu          , Xu          , Xu          , Xu          , Uu^Uf       , Ur^Em       , Xu          , Xu          , Xu          , Xu          , Xu          , Xu          , Xu          
Xu          , Xu          , Xu          , Xu          , Xu          , Xu          , Xu          , Xu          , Xu          , Xu          , Xu          , Xu          , Xu          , Xu          , Xu          , Xu          , Xu          , Xu          , Xu          , Xu          , Xu          , Xu          , Xu          , Xu          , Xu          , Xu          , Xu          , Xu          , Xu          , Uh^Em       , Xu          , Ur^Es       , Uu^Uf       , Xu          , Xu          , Xu          , Xu          , Xu          
Xu          , Xu          , Xu          , Xu          , Xu          , Xu          , Xu          , Xu          , Xu          , Xu          , Xu          , Xu          , Xu          , Xu          , Xu          , Xu          , Xu          , Xu          , Xu          , Xu          , Xu          , Xu          , Xu          , Xu          , Xu          , Xu          , Xu          , Xu          , Xu          , Xu          , Xu          , Ur^Es       , Xu          , Xu          , Xu          , Xu          , Xu          , Xu          
Xu          , Xu          , Xu          , Xu          , Xu          , Xu          , Xu          , Xu          , Xu          , Xu          , Uh          , Xu          , Uh^Emf      , Xu          , Xu          , Xu          , Xu          , Xu          , Uu^Uf       , Uh          , Uu^Vud      , Xu          , Uh          , Uh          , Uu^Uf       , Uh          , Urb         , Uu^Uf       , Uu^Uf       , Uu^Emf      , Uh          , Uu^Es       , Xu          , Xu          , Xu          , Xu          , Xu          , Xu          
Xu          , Xu          , Xu          , Xu          , Xu          , Uu^Vud      , Uh^Em       , Uh^Emf      , Uh^Emf      , Xu          , Xu          , Uh^Em       , Uu^Em       , Uh^Em       , Qxu         , Uh^Emf      , Xu          , Uh^Emf      , Xu          , Uh          , Xu          , Uu          , Urb         , Urb         , Urb         , Urb         , Urb         , Uu^Emf      , Urb         , Urb         , Xu          , Xu          , Xu          , Xu          , Xu          , Xu          , Xu          , Xu          
Xu          , Xu          , Xu          , Xu          , Uu^Uf       , Uu^Uf       , Urb^Es      , Uu^Em       , Urb         , Xu          , Xu          , Uu^Em       , Uu^Em       , Qxu         , Qxu         , Uu^Em       , Uh^Em       , Uu^Em       , Urb         , Xu          , Xu          , Xu          , Uh          , Uu          , Urb         , Urb         , Uu^Vu       , Urb         , Uu^Uf       , Uu^Emf      , Xu          , Xu          , Xu          , Xu          , Xu          , Xu          , Xu          , Xu          
Xu          , Xu          , Xu          , Uu^Vud      , Uu^Es       , Urb^Es      , Uu^Em       , Urb         , Urb         , Uh          , Uh          , Uu          , Uh          , Uu^Es       , Uh          , Qxu         , Qxu^Bs/     , Urb         , Xu          , Uu^Vu       , Xu          , Xu          , Urb         , Urb         , Urb         , Urb         , Cud         , Cud         , Cud         , Uu^Emf      , Xu          , Xu          , Xu          , Xu          , Xu          , Xu          , Xu          , Xu          
Xu          , Xu          , Uh          , Uh          , Uu          , Urb         , Xu          , Uu^Em       , Xu          , Urb         , Urb         , Uu          , Urb         , Uh          , Uu          , Urb         , Urb         , Xu          , Urb         , Xu          , Urb         , Uu^Uf       , Urb         , Uh          , Uh          , Uh          , Cud         , Qxu         , Cud         , Xu          , Xu          , Xu          , Xu          , Xu          , Xu          , Xu          , Xu          , Xu          
Xu          , Xu          , Uh          , Urb         , Xu          , Uh          , Xu          , Xu          , Xu          , Uu          , Uu          , Urb         , Urb         , Urb         , Xu          , Uu          , Uu          , Uu          , Xu          , Urb         , Uu^Uf       , Urb         , Uu          , Uu          , Xu          , Xu          , Xu          , Cud         , Kud         , Xu          , Xu          , Xu          , Xu          , Xu          , Xu          , Xu          , Xu          , Xu          
Xu          , Xu          , Urb         , Urb         , Uu          , Xu          , Uh          , Uh          , Urb         , Urb         , Xu          , Uu          , Urb         , Uu^Em       , Uu^Emf      , Xu          , Xu          , Uu          , Xu          , Xu          , Xu          , Xu          , Xu          , Xu          , Xu          , Xu          , Xu          , Xu          , Xu          , Xu          , Xu          , Xu          , Xu          , Xu          , Xu          , Xu          , Xu          , Xu          
Xu          , Xu          , Uh          , Urb         , Uu          , Urb         , Uu^Uf       , Urb         , Xu          , Xu          , Uh          , Uu          , Uu          , Uh^Em       , Uu^Uf       , Uh^Emf      , Xu          , Uu          , Xu          , Cud         , Xu          , Xu          , Xu          , Xu          , Xu          , Xu          , Xu          , Xu          , Xu          , Xu          , Xu          , Xu          , Xu          , Xu          , Xu          , Xu          , Xu          , Xu          
Xu          , Xu          , Uh          , Urb         , Urb         , Uu          , Uh          , Xu          , Xu          , Xu          , Xu          , Uh^Ii       , Urb         , Urb         , Uh          , Xu          , Uh          , Uh          , Xu          , Uu          , Uu          , Uh          , Uu^Uf       , Uh          , Uu^Uf       , Uu^Uf       , Uu^Uf       , Uh          , Uh          , Xu          , Xu          , Xu          , Xu          , Xu          , Xu          , Xu          , Xu          , Xu          
Xu          , Xu          , Uu^Es       , Uu^Es       , Uu^Es       , Urb         , Uh          , Xu          , Xu          , Uu^Uf       , Uu          , Uu^Es       , Urb         , Uu          , Xu          , Xu          , Uu          , Xu          , Uu          , Urb         , Xu          , Xu          , Uu^Uf       , Uh          , Cud         , Uu          , Cud         , Uh          , Uu^Vu       , Xu          , Xu          , Xu          , Xu          , Xu          , Xu          , Xu          , Xu          , Xu          
Xu          , Xu          , Uu          , Uu^Es       , Urb         , Urb         , Uu          , Cud         , Xu          , Uu^Vu       , Xu          , Uu          , Urb         , Urb         , Urb         , Xu          , Uu^Uf       , Uu^Uf       , Xu          , Urb         , Urb         , Uu^Uf       , Uu          , Uu          , Uu^Vud      , Kud         , Uu          , Uu          , Xu          , Xu          , Xu          , Xu          , Xu          , Xu          , Xu          , Xu          , Xu          , Xu          
Xu          , Uu^Vud      , Cud         , Uu          , Uu          , Urb         , Uu          , Uu          , Uu^Uf       , Xu          , Uh          , Urb         , Urb         , Urb         , Cud         , Xu          , Xu          , Uu^Vu       , Xu          , Xu          , Xu          , Xu          , Urb         , Urb         , Urb         , Cud         , Uu          , Uu          , Xu          , Xu          , Xu          , Xu          , Xu          , Xu          , Xu          , Xu          , Xu          , Xu          
Xu          , Cud         , Kud         , Cud         , Uu          , Urb         , Urb         , Urb         , Urb         , Urb         , Urb         , Urb         , Cud         , Urb         , Urb         , Urb         , Urb         , Xu          , Urb         , Uh          , Uu          , Urb         , Uu          , Urb         , Uu          , Urb         , Uh          , Uu          , Xu          , Xu          , Xu          , Xu          , Xu          , Xu          , Xu          , Xu          , Xu          , Xu          
Xu          , Uu^Uf       , Cud         , Uu          , Uu          , Uu          , Uh          , Uh          , Uu^Vud      , Uh^Es       , Qxu         , Xu          , Xu          , Xu          , Uh^Es       , Uu^Es       , Uu          , Urb         , Uu          , Urb         , Urb         , Urb         , Uh          , Uh          , Uh          , Uu          , Uh          , Xu          , Xu          , Xu          , Xu          , Xu          , Xu          , Xu          , Xu          , Xu          , Xu          , Xu          
Xu          , Xu          , Xu          , Uu          , Xu          , Uu          , Xu          , Uh          , Xu          , Qxu         , Qxu         , Xu          , Qxu         , Xu          , Xu          , Uh^Es       , Xu          , Uu^Uf       , Uh          , Uu^Uf       , Uu^Uf       , Uh          , Xu          , Uh          , Xu          , Qxu         , Qxu         , Uu^Uf       , Xu          , Xu          , Xu          , Xu          , Xu          , Xu          , Xu          , Xu          , Xu          , Xu          
Xu          , Xu          , Xu          , Xu          , Xu          , Xu          , Xu          , Xu          , Xu          , Xu          , Qxu         , Qxu         , Xu          , Xu          , Xu          , Xu          , Xu          , Xu          , Xu          , Xu          , Xu          , Xu          , Xu          , Xu          , Xu          , Xu          , Xu          , Xu          , Xu          , Xu          , Xu          , Xu          , Xu          , Xu          , Xu          , Xu          , Xu          , Xu          
Xu          , Xu          , Xu          , Xu          , Xu          , Xu          , Xu          , Xu          , Xu          , Xu          , Xu          , Qxu         , Xu          , Xu          , Xu          , Xu          , Xu          , Xu          , Xu          , Xu          , Xu          , Xu          , Xu          , Xu          , Xu          , Xu          , Xu          , Xu          , Xu          , Xu          , Xu          , Xu          , Xu          , Xu          , Xu          , Xu          , Xu          , Xu          
Xu          , Xu          , Xu          , Xu          , Xu          , Xu          , Xu          , Xu          , Xu          , Xu          , Xu          , Xu          , Xu          , Xu          , Xu          , Xu          , Xu          , Xu          , Xu          , Xu          , Xu          , Xu          , Xu          , Xu          , Xu          , Xu          , Xu          , Xu          , Xu          , Xu          , Xu          , Xu          , Xu          , Xu          , Xu          , Xu          , Xu          , Xu          
Xu          , Xu          , Xu          , Xu          , Xu          , Xu          , Xu          , Xu          , Xu          , Xu          , Xu          , Xu          , Xu          , Xu          , Xu          , Xu          , Xu          , Xu          , Xu          , Xu          , Xu          , Xu          , Xu          , Xu          , Xu          , Xu          , Xu          , Xu          , Xu          , Xu          , Xu          , Xu          , Xu          , Xu          , Xu          , Xu          , Xu          , Xu          
