border_size=1
usage=map

Rrc         , Aa^Fma      , Aa^Fma      , Aa          , Aa          , Aa          , Aa          , Aa          , Aa          , Aa          , Aa^Fma      , Aa^Fma      , Aa^Fma      , Aa^Fma      , Aa^Fma      , Aa          , Aa          , Aa          , Aa^Fpa      , Aa          , Aa^Fpa      , Aa          , Hhd^Fdw     , Aa          , Hhd^Fdw     , Aa          , Aa          , Aa          , Aa          , Aa          , Aa^Fma      , Aa^Fma      , Aa^Fma      , Aa          , Aa^Fma      , Aa          , Aa^Fma      , Aa          
Aa          , Rrc         , Rrc         , Aa          , Cha         , Aa          , Aa          , Aa^Vca      , Aa          , Aa^Fma      , Aa          , Aa^Fma      , Aa          , Aa          , Aa^Fpa      , Aa^Fpa      , Aa^Fpa      , Aa^Fpa      , Aa^Fpa      , Aa^Fpa      , Aa^Fpa      , Aa^Fpa      , Aa^Fpa      , Hhd^Fdw     , Aa^Fpa      , Hhd^Fdw     , Aa          , Aa^Fma      , Aa^Fma      , Aa          , Aa^Fma      , Aa^Fma      , Aa^Fma      , Aa^Fma      , Aa          , Aa^Fma      , Aa^Fma      , Aa          
Aa          , Aa          , Cha         , Ch          , Cha         , Aa          , Re          , Aa          , Aa          , Aa          , Aa          , Aa          , Aa          , Aa^Fpa      , Aa^Fpa      , Aa          , Aa          , Aa          , Aa^Fpa      , Aa          , Aa          , Aa          , Aa          , Aa^Fpa      , Aa^Fpa      , Aa          , Aa          , Aa          , Aa          , Aa^Fma      , Aa          , Aa^Fma      , Aa          , Aa          , Aa^Fma      , Aa^Fma      , Aa          , Aa^Fma      
Aa          , Aa          , Cha         , 1 Kha       , Aa          , Rrc         , Re          , Re          , Re          , Re          , Re          , Aa          , Re          , Aa          , Re          , Aa          , Re          , Aa^Fpa      , Aa^Fpa      , Aa^Fpa      , Rb          , Aa          , Rb          , Aa          , Rb          , Aa          , Aa          , Aa          , Aa^Fpa      , Aa^Fpa      , Hhd^Fdw     , Aa^Fpa      , Aa^Fpa      , Aa          , Aa^Fma      , Aa^Fpa      , Aa          , Aa^Fma      
Aa          , Aa^Vla      , Aa^Fpa      , Aa          , Aa          , Rrc         , Rrc         , Rb          , Aa          , Aa          , Aa^Fma      , Re          , Aa          , Re          , Aa          , Re          , Re          , Re          , Re          , Rb          , Aa^Fpa      , Rb          , Rd          , Rb          , Aa^Fpa      , Rb          , Cea         , Aa          , Aa          , Gll         , Aa^Fpa      , Gd^Fetd     , Aa^Fpa      , Aa^Fpa      , Aa          , Aa^Fpa      , Ha^Fpa      , Ha^Fpa      
Ha^Fma      , Aa^Fpa      , Aa^Fpa      , Aa          , Aa          , Aa          , Rrc         , Rb          , Aa          , Aa          , Aa^Fma      , Aa          , Aa          , Aa          , Aa          , Aa          , Aa^Fpa      , Aa          , Aa          , Re          , Re          , Re          , Aa^Fpa      , Aa^Fpa      , Aa^Vca      , Gll         , Cea         , 3 Kea       , Aa^Fpa      , Aa^Fpa      , Aa          , Aa^Fpa      , Re          , Aa          , Aa          , Aa          , Ha^Fpa      , Ha^Fpa      
Ha^Fma      , Aa^Fpa      , Aa^Fpa      , Aa^Fpa      , Aa          , Aa          , Rrc         , Rrc         , Aa          , Aa          , Aa          , Aa^Fma      , Aa^Fma      , Aa^Fma      , Aa          , Aa^Fpa      , Aa          , Aa          , Aa          , Rb          , Rb          , Aa^Fpa      , Aa          , Aa^Fpa      , Aa          , Gll         , Aa          , Cea         , Re          , Re          , Re          , Re          , Aa^Fpa      , Re          , Re          , Ha^Fpa      , Aa          , Ha^Fpa      
Ha^Fma      , Ha^Fpa      , Ha^Fpa      , Aa^Fpa      , Aa          , Aa          , Rrc         , Aa          , Aa          , Aa^Fma      , Aa^Fma      , Aa^Fma      , Aa          , Aa^Fma      , Aa          , Aa^Fpa      , Aa^Fpa      , Aa^Fpa      , Aa^Fpa      , Aa          , Aa          , Rb          , Rb          , Rb          , Rb          , Aa          , Rb          , Rb          , Aa          , Aa          , Aa^Fpa      , Aa^Fpa      , Ms          , Aa^Fpa      , Aa          , Re          , Re          , Ha^Fpa      
Ha^Fpa      , Ha^Fpa      , Aa          , Aa^Fpa      , Aa          , Aa          , Rrc         , Aa          , Aa          , Aa^Fma      , Aa^Fma      , Aa          , Aa          , Aa          , Aa          , Aa^Vea      , Aa^Fma      , Aa          , Aa^Fma      , Aa          , Aa          , Aa          , Aa          , Rb          , Aa          , Rb          , Aa          , Aa          , Ms          , Ha          , Ms^Xm       , Ms          , Ms          , Aa          , Aa          , Re          , Aa          , Re          
Ha^Fpa      , Aa          , Aa          , Aa          , Aa          , Aa          , Rrc         , Rb          , Aa          , Aa          , Aa^Fma      , Aa^Fma      , Aa^Fma      , Aa          , Aa          , Aa^Fma      , Aa          , Aa^Fma      , Aa          , Aa^Fma      , Aa          , Aa^Fma      , Aa          , Aa          , Aa          , Aa          , Aa          , Aa          , Ms          , Ms^Xm       , Aa^Fpa      , Ms^Xm       , Ha^Fpa      , Ha^Fma      , Re          , Re          , Aa          , Aa          
Aa          , Ha^Fpa      , Aa          , Aa          , Aa          , Rb          , Rrc         , Rb          , Rb          , Aa          , Aa          , Aa^Fma      , Aa^Fma      , Aa^Fda      , Aa^Fda      , Aa^Fma      , Ai          , Ai          , Ai          , Aa          , Ai          , Aa^Fma      , Aa          , Aa^Fpa      , Aa^Fpa      , Aa          , Aa          , Aa^Fpa      , Aa^Fpa      , Ms          , Ha^Fpa      , Aa^Fpa      , Aa^Fda      , Ha          , Re          , Re          , Aa          , Aa          
Aa          , Aa          , Aa          , Aa          , Rrc         , Rrc         , Aa^Fda      , Gd^Fetd     , Rb          , Rb          , Aa^Fda      , Aa^Fda      , Ai          , Ai          , Ai          , Ai          , Ww          , Ai          , Ww          , Ai          , Ai          , Aa          , Aa          , Aa          , Aa^Fpa      , Aa^Fpa      , Aa^Fpa      , Aa^Fpa      , Aa^Fpa      , Aa          , Re          , Re          , Re          , Re          , Re          , Aa          , Aa^Fda      , Aa          
Aa          , Aa          , Aa          , Rb          , Rb          , Rrc         , Aa^Vca      , Aa^Fda      , Rb          , Aa^Fda      , Ai          , Ai          , Ww          , Ww          , Ww          , Ww          , Ai          , Ai          , Ww          , Ww          , Ai          , Ai          , Aa          , Aa          , Aa^Fpa      , Aa          , Aa^Fpa      , Aa^Fpa      , Re          , Re          , Aa          , Re          , Aa^Fpa      , Aa          , Aa          , Aa          , Aa^Fda      , Aa          
Aa          , Aa          , Aa          , Aa          , Re          , Rrc         , Rrc         , Aa^Fda      , Rb          , Ai          , Ai          , Ww^Vm       , Ww          , Ww          , Ww          , Ww          , Ww          , Ww          , Ww          , Ww          , Ai          , Ai          , Aa^Fda      , Aa          , Aa^Fpa      , Aa^Vea      , Aa^Fpa      , Aa^Fpa      , Re          , Re          , Aa          , Aa          , Aa          , Aa^Fpa      , Aa          , Aa          , Aa^Fpa      , Aa          
Aa          , Aa          , Aa^Fda      , Aa          , Aa          , Re          , Rrc         , Rrc         , Rrc         , Ai          , Ww          , Ai          , Ww          , Ai          , Ww          , Ww          , Ai          , Ww          , Ww          , Ai          , Aa          , Aa          , Aa          , Aa          , Aa^Fpa      , Aa          , Aa          , Aa          , Re          , Aa          , Aa          , Aa          , Aa          , Aa          , Ai          , Aa^Fda      , Aa^Fpa      , Aa^Fda      
Aa          , Aa^Fpa      , Aa^Fpa      , Aa          , Aa          , Cha         , Aa          , Rrc         , Aa          , Ai^Bw\      , Ai^Bw\      , Ai          , Cha         , Ai          , Ai          , Ai          , Ai          , Ai          , Ai          , Ai          , Aa          , Aa          , Aa          , Aa          , Aa          , Aa^Fpa      , Aa          , Re          , Aa          , Aa          , Aa          , Aa^Fpa      , Aa          , Ai          , Aa^Fpa      , Aa^Vea      , Aa^Fpa      , Aa^Fpa      
Aa^Fpa      , Aa^Fpa      , Aa^Fda      , Aa^Fpa      , Aa          , Aa^Fda      , Aa^Fda      , Aa^Fda      , Aa^Fda      , Ai          , Wog         , Rrc         , Rrc         , Rrc         , Rrc         , Aa^Vha      , Rb          , Aa          , Aa          , Aa          , Aa^Fpa      , Aa          , Aa^Fpa      , Aa          , Aa^Fpa      , Aa^Fpa      , Aa^Fpa      , Re          , Re          , Aa^Fpa      , Aa^Fpa      , Aa^Fpa      , Aa          , Aa^Fpa      , Aa^Fpa      , Aa^Fpa      , Aa          , Aa^Fpa      
Aa^Fpa      , Aa          , Aa^Fpa      , Aa^Fda      , Aa^Fda      , Aa^Fda      , Aa          , Aa          , Ai          , Ai          , Ai          , Aa^Fma      , Aa^Fma      , Rrc         , Rb          , Rrc         , Rrc         , Rb          , Aa          , Aa^Fpa      , Aa^Fpa      , Aa^Fpa      , Aa^Fpa      , Aa          , Aa          , Aa          , Aa          , Aa          , Re          , Re          , Re          , Aa          , Aa          , Aa^Fpa      , Aa          , Aa^Fpa      , Aa^Fpa      , Aa          
Aa          , Aa^Fpa      , Aa          , Aa^Fpa      , Aa^Fda      , Aa          , Aa          , Ai          , Aa          , Ai          , Ai          , Aa^Fma      , Ms          , Ms          , Ms          , Rb          , Rrc         , Rrc         , Aa          , Aa^Fpa      , Aa          , Aa^Fpa      , Aa          , Aa^Fpa      , Aa          , Aa          , Aa          , Aa          , Aa          , Aa          , Aa          , Re          , Re          , Aa          , Aa          , Ha^Fma      , Ms          , Ms          
Aa          , Aa          , Aa^Fpa      , Aa          , Aa          , Aa          , Ai          , Ai          , Aa          , Aa          , Ai          , Ms          , Ms^Xm       , Ms^Xm       , Ha          , Aa          , Aa          , Rrc         , Rrc         , Aa          , Aa          , Aa          , Aa          , Aa          , Aa          , Aa^Vea      , Aa^Fda      , Aa^Fpa      , Aa^Fpa      , Aa          , Aa          , Aa          , Aa          , Re          , Aa          , Ha^Fma      , Ms          , Ms          
Aa          , Aa^Fpa      , Aa          , Aa          , Aa          , Ai          , Ai          , Aa          , Aa          , Aa          , Ai          , Ms^Xm       , Ms^Xm       , Ms^Xm       , Ha^Fma      , Aa          , Aa          , Rb          , Aa          , Rrc         , Rrc         , Rrc         , Rrc         , Aa          , Aa          , Aa          , Aa          , Aa^Fda      , Aa          , Aa          , Aa          , Aa          , Re          , Re          , Aa          , Aa          , Ha^Fma      , Ms^Xm       
Aa^Fpa      , Aa^Fpa      , Aa          , Aa          , Wog         , Wog         , Aa          , Aa          , Aa          , Ai          , Aa          , Ms          , Ww          , Ms          , Ha          , Ha          , Ha          , Aa          , Aa^Fma      , Aa          , Aa          , Rrc         , Aa          , Rrc         , Rrc         , Rrc         , Rrc         , Aa          , Rb          , Aa          , Rb          , Re          , Rb          , Aa          , Aa          , Aa          , Aa          , Ms^Xm       
Aa          , Aa^Fpa      , Aa          , Aa          , Wog         , Wog         , Aa          , Aa          , Ai          , Ai          , Ai          , Ww          , Ha^Fma      , Ww          , Ha^Fma      , Ms          , Ha          , Aa          , Aa^Fma      , Aa^Fma      , Aa^Fma      , Aa^Fma      , Aa^Fpa      , Aa^Fpa      , Aa^Fpa      , Aa          , Rrc         , Rrc         , Ha          , Rb          , Aa^Fda      , Rb          , Aa          , Rb          , Rb          , Rb          , Rb          , Rb          
Aa          , Aa          , Ai          , Ai          , Aa          , Aa          , Aa          , Aa          , Ai          , Ai          , Aa          , Ha^Fma      , Aa          , Ha^Fma      , Ha^Fpa      , Ha          , Ha          , Aa          , Aa          , Aa^Fda      , Aa^Fpa      , Aa^Fpa      , Rrc         , Rrc         , Rrc         , Rrc         , Rrc         , Ha          , Ms          , Ha          , Aa^Fma      , Aa^Fpa      , Coa         , Aa          , Coa         , Aa          , Aa          , Aa          
Ai          , Ai          , Aa          , Ai          , Ai          , Ai          , Ai          , Ai          , Ms          , Aa          , Ha          , Aa          , Aa          , Ha^Fma      , Ha^Fpa      , Ha^Fpa      , Rb          , Rb          , Rrc         , Rb          , Rrc         , Aa          , Rrc         , Rrc         , Re          , Re          , Re          , Rrc         , Rrc         , Aa^Fpa      , Aa^Fma      , Aa          , Coa         , 2 Koa       , Aa          , Aa          , Aa          , Aa          
Aa^Fpa      , Aa^Fpa      , Aa^Fpa      , Aa          , Ai          , Ai          , Aa          , Aa          , Ms          , Ha          , Aa^Fpa      , Aa^Fpa      , Aa^Fpa      , Ha^Fma      , Aa          , Rrc         , Rrc         , Rrc         , Rb          , Rrc         , Aa          , Rrc         , Aa          , Aa          , Aa          , Re          , Aa          , Re          , Rrc         , Re          , Aa^Voa      , Aa          , Aa          , Rb          , Aa          , Aa          , Aa          , Aa          
Ai          , Ai          , Ai          , Ai          , Aa          , Ai          , Aa          , Ms          , Ms          , Aa^Fpa      , Aa          , Aa          , Aa^Fma      , Aa^Fma      , Aa          , Rrc         , Rrc         , Rb          , Aa          , Aa          , Aa          , Ha^Fda      , Ha^Fpa      , Ha^Fda      , Ha^Fda      , Ha^Fda      , Aa          , Re          , Rrc         , Rrc         , Rrc         , Rrc         , Rrc         , Rrc         , Rrc         , Aa          , Aa          , Aa          
Aa          , Ai          , Ww          , Ha          , Ha          , Ha          , Ms          , Ms          , Aa^Fpa      , Aa^Fpa      , Aa          , Aa^Fma      , Aa          , Aa          , Aa          , Rb          , Rrc         , Rb          , Aa          , Aa          , Ha^Fda      , Ha^Fda      , Ha^Fpa      , Ha^Fpa      , Aa          , Aa          , Aa          , Aa          , Re          , Re          , Re          , Rrc         , Aa^Fpa      , Rrc         , Aa          , Rrc         , Re          , Aa          
Ms^Xm       , Ms^Xm       , Aa^Fpa      , Aa^Fpa      , Aa^Fpa      , Aa^Fpa      , Aa^Fpa      , Aa^Fpa      , Aa^Fpa      , Aa^Fpa      , Aa          , Aa^Fma      , Aa          , Aa          , Rb          , Rrc         , Rb          , Aa          , Aa^Fpa      , Aa          , Aa^Fda      , Aa          , Aa          , Ha^Fpa      , Ha^Fpa      , Aa          , Aa          , Aa          , Aa          , Aa          , Aa          , Aa          , Aa^Fpa      , Aa          , Aa          , Rrc         , Rrc         , Aa          
Ms^Xm       , Ms^Xm       , Ms^Xm       , Ms^Xm       , Aa          , Aa^Fpa      , Aa          , Aa^Fma      , Aa^Fma      , Aa^Fpa      , Aa^Fpa      , Aa          , Rb          , Rb          , Rrc         , Rrc         , Aa^Fpa      , Aa^Fpa      , Aa^Fda      , Aa^Fpa      , Aa^Fda      , Aa^Fda      , Ha^Fpa      , Ha^Fpa      , Ha^Fpa      , Aa          , Aa^Fpa      , Aa          , Aa^Voa      , Aa^Fpa      , Aa^Fpa      , Aa^Fpa      , Aa^Fpa      , Aa^Fpa      , Aa          , Aa          , Rrc         , Aa          
Ms^Xm       , Ms^Xm       , Ms^Xm       , Ms^Xm       , Aa^Fpa      , Aa^Fma      , Aa^Fma      , Aa^Fma      , Aa^Fma      , Aa^Fpa      , Aa          , Aa          , Rrc         , Rrc         , Aa          , Aa          , Aa^Fda      , Aa^Fpa      , Aa^Fpa      , Ha^Fpa      , Ha^Fpa      , Ha^Fpa      , Aa          , Ha^Fpa      , Aa          , Aa          , Aa          , Aa^Fpa      , Aa^Fpa      , Aa^Fpa      , Aa^Fpa      , Aa^Fpa      , Aa^Fpa      , Aa          , Aa          , Aa          , Aa          , Rrc         
Ms^Xm       , Aa^Fpa      , Aa^Fpa      , Aa^Fpa      , Aa          , Aa^Fma      , Aa^Fpa      , Aa^Fma      , Aa          , Aa          , Rrc         , Rrc         , Aa          , Aa          , Aa          , Aa          , Aa          , Aa          , Aa          , Aa^Fda      , Aa          , Aa          , Aa          , Aa          , Aa          , Aa          , Aa          , Aa          , Aa^Fpa      , Aa^Fpa      , Aa^Fpa      , Aa^Fpa      , Aa^Fpa      , Aa^Fpa      , Aa          , Aa          , Aa          , Rrc         
