border_size=1
usage=map

Xu          , Xu          , Xu          , Xu          , Xu          , Xu          , Uu          , Xu          , Uu^Uf       , Uu^Uf       , Uu^Ufi      , Xu          , Xu          , Xu          , Xu          , Xu          , Xu          , Xu          , Xu          , Xu          , Uu^Ufi      , Uh          , Uu^Uf       , Xu          , Uu          , Xu          , Xu          , Xu          , Xu          , Xu          , Xu          , Xu          
Xu          , Uu^Uf       , 1 Kud       , Cud         , Urb         , Rr^Vd       , Ur          , Ur          , Ur          , Uu^Uf       , Uu          , Uu^Ufi      , Uu^Vu       , Xu          , Uh          , Cud         , Kud         , Cud         , Uu^Vu       , Xu          , Uh          , Uu^Uf       , Uu^Uf       , Uu^Ufi      , Uu          , Uu^Uf       , Uu^Uf       , Uu^Vud      , Uu^Em       , Uu^Vud      , Uu^Emf      , Xu          
Xu          , Uu^Emf      , Cud         , Cud         , Urb         , Uu          , Uu          , Uu          , Ur^Em       , Ur          , Ur          , Uu          , Ur          , Ur          , Xu          , Xu          , Cud         , Uu          , Urb         , Uh          , Urb         , Uu          , Uh          , Ur          , Ur^Es       , Ur          , Uh          , Uu^Em       , 2 Kud       , Cud         , Uu^Em       , Xu          
Xu          , Uu^Emf      , Uu          , Urb         , Urb         , Urb         , Uu          , Uu^Uf       , Uu^Vu       , Uu^Uf       , Ur          , Ur          , Qxu         , Uu^Ufi      , Uu          , Xu          , Xu          , Xu          , Uu^Uf       , Urb         , Uu^Uf       , Uu          , Urb         , Xu          , Uu^Uf       , Ur          , Ur          , Cud         , Cud         , Uu          , Uu^Vud      , Xu          
Xu          , Rr^Vd       , Uu          , Uu          , Uu^Es       , Xu          , Uu^Uf       , Xu          , Uh^Emf      , Uh^Em       , Uu          , Uu          , Uu^Uf       , Qxu         , Ur          , Xu          , Uh^Em       , Uu^Vu       , Ql          , Ql          , Uu          , Uh          , Uu          , Uu^Ufi      , Uu          , Ur          , Ur          , Uu          , Ur          , Uu          , Uu^Ufi      , Xu          
Xu          , Xu          , Cud         , Uh          , Xu          , Xu          , Xu          , Uu          , Urb         , Uu^Uf       , Uu^Uf       , Ur          , Ur^Es       , Ur          , Uu          , Ur          , Ur          , Ur          , Urb         , Urb         , Urb         , Urb         , Urb         , Uu          , Ur          , Uu          , Xu          , Ur          , Uh          , Uu          , Xu          , Xu          
Xu          , Xu          , Qxu         , Xu          , Xu          , Xu          , Xu          , Urb         , Uh          , Uu^Uf       , Xu          , Qxu         , Xu          , Uu^Em       , Ur          , Ur          , Uu          , Ur          , Cud         , Urb         , Ur          , Uu^Es       , Qxua        , Ur          , Ur          , Xu          , Xu          , Xu          , Xu          , Cud         , Wo          , Xu          
Xu          , Xu          , Qxu         , Qxu         , Xu          , Xu          , Xu          , Xu          , Urb         , Uh          , Xu          , Xu          , Uu^Emf      , Uu^Vud      , Ur          , Cud         , Ur          , Ur          , Ur          , Uh          , Uu^Vud      , Xu          , Xu          , Ur          , Xu          , Rr^Vd       , Xu          , Ss          , Wo^Es       , Wo          , Wo          , Wo^Es       
Xu          , Cud         , Xu          , Xu          , Xu          , Xu          , Ur^Emf      , Xu          , Uh          , Uu^Uf       , Uu          , Uu^Uf       , Qxu         , Qxu         , Uu          , Ur          , Ur          , Uu^Uf       , Uu          , Uu^Uf       , Uh          , Xu          , Xu          , Xu          , Xu          , Xu          , Xu          , Wo^Em       , Cud         , Wo^Es       , Xu          , Xu          
Xu          , Uh          , Uu^Ufi      , Uu^Uf       , Uh^Em       , Uu^Vud      , Xu          , Ur          , Uu^Uf       , Xu          , Uu          , Uh          , Uu          , Uu          , Uu^Ufi      , Uu^Uf       , Uu^Vu       , Uh          , Ur^Em       , Uu          , Uu          , Uu          , Uu          , Uh          , Uu          , Uu^Vud      , Xu          , Xu          , Uu          , Xu          , Uu^Uf       , Xu          
Xu          , Uu          , Uu          , Uu          , Uu          , Xu          , Uu          , Xu          , Ur          , Uu^Uf       , Ur^Es       , Uu          , Urb         , Uu          , Uu^Uf       , Xu          , Xu          , Xu          , Xu          , Uh          , Ur          , Uu^Ufi      , Uu          , Ql          , Urb         , Uh          , Xu          , Uu          , Uu          , Urb         , Urb         , Xu          
Xu          , Uu^Vu       , Uu^Es       , Uu          , Cud         , Ur          , Ur          , Uu^Uf       , Ur          , Ur          , Ur^Es       , Uu          , Xu          , Uh          , Xu          , Xu          , Xu          , Xu          , Uh^Emf      , Xu          , Uh^Em       , Uh          , Uh          , Uu          , Uh          , Uu^Uf       , Uu          , Uu          , Cud         , Uu^Vu       , Uh          , Xu          
Xu          , Uu          , Cud         , 3 Kud       , Uu^Vu       , Uu          , Uh          , Ur          , Uu          , Uu          , Uu          , Uu          , Xu          , Xu          , Uu^Uf       , Uh          , Cud         , Uu^Uf       , Uh          , Xu          , Xu          , Xu          , Ur          , Uu          , Uh          , Uu          , Uu          , Urb         , 4 Kud       , Uu          , Uu^Vu       , Xu          
Xu          , Uu^Vu       , Uu^Emf      , Cud         , Uu^Uf       , Uh          , Uu^Uf       , Uh          , Xu          , Xu          , Uu^Uf       , Uu          , Cud         , Uh          , Xu          , Xu          , Xu          , Xu          , Wwf         , Wwf         , Uh          , Uu^Uf       , Uu^Uf       , Uu          , Uu          , Urb         , Uu^Vu       , Cud         , Xu          , Uh          , Uh^Emf      , Xu          
Xu          , Xu          , Xu          , Xu          , Xu          , Xu          , Xu          , Xu          , Xu          , Uh          , Xu          , Xu          , Xu          , Xu          , Xu          , Xu          , Xu          , Ss          , Xu          , Xu          , Xu          , Xu          , Xu          , Xu          , Xu          , Xu          , Xu          , Xu          , Xu          , Xu          , Xu          , Xu          
