border_size=1
usage=map

Ql          , Xu          , Ql          , Ql          , Ql          , Ql          , Ql          , Ql          , Xu          , Xu          , Xu          , Xu          , Urb         , Xu          , Xu          , Xu          , Xu          , Xu          , Xu          , Xu          , Qxu         , Qxu^Br|     , Qxu         , Xu          , Xu          , Xu          , Xu          , Xu          , Xuc         , Xuc         , Xuc         , Xuc         , Xu          , Xuc         , Uu^Vud      , Xuc         , Xuc         , Xuc         , Xuc         , Xu          , Uu^Uf       , Xu          , Xu          , Xu          , Xu          , Xu          , Xu          , Xu          , Xu          , Qxu         , Qxu^Bs|     , Qxu         , Xu          , Xu          , Qxu         , Qxu         , Qxu         , Qxu         
Xu          , Ql          , Qlf         , Qlf         , Xu          , Ql          , Xu          , Ql          , Uu^Es       , Xu          , Uu          , Urb^Es      , Uu^Es       , Xu          , Uu^Vu       , Uh          , Rb^Es       , Xu          , Uu^Uf       , Xu          , Xu          , Qxu^Br|     , Xu          , Xu          , Xuc         , Xu          , Xuc         , Xuc         , Rr          , Rr          , Rr          , Xuc         , Xuc         , Uu^Vud      , Ur          , Uh          , Uu          , Uh          , Uh          , Uu          , Uu^Uf       , Xu          , Xu          , Xu          , Uu^Uf       , Uh          , Uh          , Uu          , Uu          , Qxu         , Cud         , Qxu         , Ur          , Uh          , Qxu^Bs\     , Qxu         , Qxu         , Qxu         
Qlf         , Uh          , Uh^Dr       , Uu^Vud      , Uue         , Xu          , Uu^Vud      , Uh          , Xu          , Uu^Es       , Xu          , Rb^Em       , Uh          , Urb         , Urb         , Uu^Es       , Xu          , Urb^Es      , Uu^Vud      , Uu          , Ur^Es       , Ur^Br|      , Xu          , Xuc         , Uu^Vud      , Xuc         , Uu^Vud      , Xuc         , Rr          , Rr          , Rr          , Xuc         , Uh^Em       , Uu^Em       , Urb         , Ur          , Uu          , Xuc         , Xuc         , Xu          , Xu          , Uh          , Uu^Em       , Xu          , Uu^Em       , Xu          , Uh          , Xu          , Uu          , Qxu^Bs/     , Qxu         , Ur^Es       , Qxu         , Uu          , Qxu^Bs/     , Cud         , Qxu         , Qxu         
Qlf         , Uue         , Cud         , Qlf         , Uh          , Xu          , Xu          , Xu          , Uu          , Urb^Es      , Uh          , Xu          , Cud         , Kud         , Uh^Em       , Uu^Vud      , Xu          , Xu          , Xu          , Xu          , Uu^Br/      , Ur^Br|      , Xuc         , Qxu^Bs\     , Uu^Vud      , Urb         , Urb         , Uu^Es       , Uu^Es       , Rr          , Uu^Esd      , Uu^Em       , Ur          , Uu          , Urb         , Urb         , Urb         , Uh          , Xuc         , Xuc         , Xu          , Uu^Vu       , Xu          , Uh          , Xu          , Uh^Em       , Xu          , Uu          , Xu          , Xu          , Uu^Uf       , Qxu         , Uu^Es       , Ur          , Qxu         , Qxu         , Ur^Es       , Qxu^Bs/     
Xu          , Xu          , Qlf         , Uu          , Xu          , Qlf         , Xu          , Xu          , Uu^Es       , Uu^Es       , Xu          , Xu          , Xu          , Xu          , Xu          , Xu          , Xu          , Xu          , Uh^Em       , Uu^Br|      , Xu          , Xuc         , Uu^Vud      , Qxu^Bs\     , Urb         , Uu^Em       , Urb         , Uh          , Urb         , Urb         , Urb         , Urb         , Xuc         , Urb         , Urb         , Urb         , Cud         , Uu^Uf       , Xuc         , Xuc         , Xu          , Xu          , Xu          , Xu          , Uh          , Uu^Es       , Xu          , Uh          , Xu          , Xu          , Qxu^Bs/     , Ur^Es       , Qxu         , Ur^Es       , Uu^Es       , Qxu^Bs/     , Qxu^Bs|     , Ur          
Qxu^Bs/     , Uh          , Uu^Uf       , Uu^Em       , Uu^Es       , Xu          , Uu^Es       , Uue^Es      , Xu          , Uu^Uf       , Xu          , Xu          , Uu^Uf       , Xu          , Uu^Uf       , Xu          , Xu          , Xu          , Xu          , Uu^Br|      , Xu          , Xuc         , Xuc         , Uu^Em       , Urb^Es      , Urb         , Urb         , Urb         , Ur          , Cud         , Ur          , Urb         , Urb^Em      , Urb         , Urb         , Urb         , Kud         , Xuc         , Xuc         , Kud         , Cud         , Cud         , Ur          , Uu^Uf       , Uu^Vu       , Xu          , Uu^Vud      , Uu          , Xu          , Uu^Vu       , Qxu         , Qxu         , Qxu         , Qxu^Bs|     , Qxu         , Qxu         , Uh          , Qxu         
Xu          , Uh          , Xu          , Xu          , Xu          , Ur          , Uu          , Uh          , Urb         , Xu          , Uh          , Uh^Es       , Uue         , Uu^Em       , Uh^Es       , Uh^Em       , Xu          , Xu          , Ur^Br|      , Ur^Br/      , Xuc         , Xuc         , Xuc         , Urb         , Urb         , Urb         , Urb         , Cud         , Cud         , Kud         , Cud         , Cud         , Urb         , Urb         , Urb         , Urb         , Cud         , Xuc         , Xuc         , Cud         , Ur          , Ur          , Ur          , Uu          , Uh          , Xu          , Xu          , Xu          , Rb^Em       , Qxu         , Qxu^Bs/     , Ur^Em       , Uu^Em       , Rb          , Qxu         , Uu^Em       , Ur          , Qxu         
Xu          , Xu          , Xu          , Uu^Vu       , Uu          , Ur          , Xu          , Urb         , Ql          , Xu          , Xu          , Uu^Uf       , Sm^Em       , Uu^Es       , Uh          , Uh          , Xu          , Xu          , Uu^Br|      , Xu          , Xu          , Uu^Vud      , Cud^Es      , Uu^Em       , Uu          , Uh          , Uu^Uf       , Urb         , Urb         , Cud         , Urb         , Urb         , Ur          , Urb         , Urb         , Urb         , Urb         , Uu^Uf       , Uu^Vud      , Xuc         , Uh          , Uu^Vud      , Qxu         , Uu          , Ur          , Uu^Em       , Uu^Uf       , Qxu         , Uu^Es       , Ur^Em       , Qxu         , Qxu         , Qxu         , Qxu         , Uh          , Qxu^Bs/     , Qxu         , Qxu         
Ss^Bw\r     , Xue         , Ss^Em       , Xue         , Uue         , Xu          , Xu          , Uu^Vud      , Xu          , Mv          , Xu          , Wwf^Emf     , Xu          , Wwrg        , Xu          , Uu^Uf       , Xu          , Xu          , Ur^Br\      , Uh^Es       , Uh^Em       , Xu          , Xu          , Uu          , Urb         , Xuc         , Qxu^Bs/     , Uu^Vud      , Xuc         , Urb         , Uu^Vud      , Uu^Em       , Uu^Uf       , Urb         , Urb         , Urb         , Ur          , Uu^Emf      , Uu^Vu       , Xuc         , Ur          , Qxu         , Qxu         , Qxu         , Ur          , Uu^Em       , Uu^Es       , Qxu^Bs/     , Qxu         , Qxu^Bs|     , Qxu         , Xu          , Qxu         , Xu          , Qxu         , Ur          , Uu^Em       , Xu          
Wog^Bw/r    , Chs^Em      , Sm^Em       , Xue         , Xue         , Uu^Em       , Uu^Ufi      , Xu          , Uu^Vu       , Xu          , Wwrt        , Xu          , Wo^Emf      , Xu          , Xu          , Wwf         , Xu          , Xu          , Xu          , Uu^Br\      , Uu^Br|      , Xu          , Xuc         , Xuc         , Uh          , Urb         , Xuc         , Qxu         , Xuc         , Uh          , Xuc         , Uu^Emf      , Uu^Em       , Urb         , Uh          , Urb         , Uh^Emf      , Uu^Vu       , Xuc         , Xuc         , Uh          , Ur          , Uu          , Ur          , Uu^Uf       , Ur          , Uu^Em       , Uu          , Uu^Em       , Qxu^Bs|     , Uu^Emf      , Xu          , Xu          , Qxu         , Ur          , Qxu         , Uu^Em       , Xu          
Sm^Ii       , Wwg^Efm     , Xue         , Xue         , Uu^Esd      , Uu^Es       , Uh^Em       , Uu^Uf       , Uu^Br|      , Wwf^Br/     , Qxu^Br\     , Qxu         , Wog^Em      , Xu          , Wwg^Ii      , Xu          , Ur^Br\      , Xu          , Xu          , Xu          , Uu^Br|      , Uu^Em       , Xuc         , Cud         , Uu^Uf       , Uu          , Urb         , Uu          , Urb         , Xuc         , Xuc         , Uu^Uf       , Uu^Emf      , Uu^Em       , Xuc         , Uh^Em       , Xuc         , Xuc         , Uu^Vud      , Xuc         , Uu^Es       , Uu^Vud      , Ur          , Ur          , Rr^Vd       , Qxu         , Qxu         , Qxu         , Qxu         , Uu          , Uu^Uf       , Uh          , Xu          , Uh^Es       , Xu          , Ur          , Xu          , Xu          
Ss^Br/      , Ss^Br/      , Sm^Br\      , Xue         , Ur^Br/      , Ur^Br/      , Uu^Br\      , Xu          , Uue^Br/     , Xu          , Xu          , Qxu^Br\     , Ur^Br\      , Xu          , Qxu^Br/     , Ur^Br/      , Rb^Es       , Uu^Br\      , Uu^Br\      , Urb^Es      , Uu^Br/      , Xu          , Xu          , Xuc         , Xu          , Xuc         , Urb         , Xu          , Uu^Vu       , Uu          , Uu^Em       , Uue^Emf     , Uh^Emf      , Uu^Em       , Uu^Uf       , Xuc         , Uu^Uf       , Xuc         , Xu          , Uu^Es       , Uu^Uf       , Ur          , Rr^Vd       , Ur          , Ur          , Uu^Vud      , Uu^Uf       , Rr^Vd       , Qxu^Bs/     , Uu          , Uu^Emf      , Xu          , Xu          , Uu^Uf       , Uu^Uf       , Xu          , Xu          , Xu          
Xue         , Xue         , Wwf^Es      , Sm^Br\      , Xue         , Sm^Esd      , Xue         , Uue^Br\     , Uu^Ufi      , Uue^Em      , Rp^Em       , Uh^Em       , Rp^Ii       , Qxu^Br\     , Qxu^Bs/     , Qxu^Bs/     , Wwrg        , Xu          , Uu^Vud      , Uu^Br\      , Xu          , Xu          , Xu          , Xu          , Xu          , Uh^Es       , Uu^Es       , Xu          , Xu          , Xu          , Urb         , Uu^Em       , Uu^Uf       , Uu^Emf      , Uu^Uf       , Uu^Uf       , Xu          , Uu^Em       , Xu          , Uh^Es       , Uu          , Ur          , Xu          , Rr^Vd       , Uu^Vud      , Ur          , Ur          , Ur          , Uh^Em       , Qxu         , Xu          , Xu          , Xu          , Uu^Vu       , Xu          , Uh          , Uu^Emf      , Uh          
Ww^Ewl      , Uh^Em       , Wog^Es      , Wwf^Em      , Xue         , Xue         , Ss^Em       , Xue         , Ww^Vm       , Xue         , Wwrg        , Sm^Ii       , Wwf^Em      , Rp          , Xu          , Qxu         , Qxu         , Xu          , Uu^Vu       , Uu^Br|      , Uu^Br\      , Uh          , Uu^Uf       , Uu          , Uue         , Uu          , Xu          , Xu          , Kud         , Cud         , Cud         , Urb         , Uu^Uf       , Uu^Emf      , Uu^Emf      , Uu^Emf      , Uu^Emf      , Uu^Em       , Uh^Emf      , Xu          , Uu          , Uh          , Xu          , Xu          , Xu          , Uh          , Ur          , Uu^Em       , Rb          , Xu          , Xu          , Xu          , Uh          , Xu          , Xu          , Xu          , Uu^Em       , Xu          
Ww^Ewf      , Wwrg        , Wog         , Wog         , Xue         , Xu          , Xu          , Ww^Ii       , Wwf^Ii      , Ss          , Xue         , Wwf^Em      , Ss          , Xue         , Wot         , Qxu         , Wot^Es      , Xu          , Uh^Br|      , Uu^Br/      , Uue         , Uue^Br|     , Xu          , Xu          , Xu          , Uue         , Xu          , Xu          , Cud         , Cud         , Uu^Uf       , Uu^Uf       , Uu^Uf       , Uu^Em       , Uu^Emf      , Uu^Emf      , Uu^Uf       , Uh^Emf      , Xu          , Xu          , Uu          , Xu          , Xu          , Xu          , Xu          , Uu^Vu       , Xu          , Ur          , Uu          , Uu          , Ur          , Uh          , Xu          , Ur          , Uu          , Uu^Em       , Uh          , Xu          
Ss          , Wog         , Wog         , Wwrg        , Sm          , Xue         , Xue         , Chs         , Chw         , Ss          , Xu          , Ss          , Wwr         , Ss^Vhs      , Wot         , Wot         , Wot^Es      , Wwrt        , Wwg^Br/     , Xue         , Xu          , Uue^Br|     , Xu          , Uu^Vud      , Uu          , Uu          , Xu          , Uu^Vu       , Uu          , Uu^Em       , Uu^Em       , Uu^Em       , Uu^Em       , Uu^Em       , Xu          , Uu^Emf      , Xu          , Xu          , Uu^Es       , Uu          , Uh          , Uu          , Uu          , Xu          , Uu^Uf       , Xu          , Uu          , Uu          , Uu^Em       , Uu          , Xu          , Cud         , Xu          , Xu          , Uu          , Xu          , Uu          , Xu          
Ss          , Ds          , Wog         , Wwrg        , Wwf         , Xue         , Chs         , 2 Khs       , Xue         , Chr         , Md          , Xu          , Ww^Em       , Wot         , Ww^Vm       , Wot         , Xue         , Wwr^Br|     , Xue         , Xue         , Uu^Vu       , Xu          , Uh^Em       , Uh^Emf      , Uu          , Ur          , Ur          , Xu          , Rr^Vd       , Xu          , Xu          , Uu^Em       , Uu          , Uu^Em       , Uu          , Xu          , Ur          , Xu          , Ur          , Uu          , Ur^Em       , Uu          , Uu          , Ur          , Ur          , Ur          , Xu          , Uu          , Uu          , Xu          , Uu^Uf       , Xu          , Ur          , Uu^Es       , Uu^Em       , Ur          , Xu          , Uh          
Xue         , Wog         , Sm          , Wog         , Ss^Bw/r     , Chs         , Ss          , Xue         , Xue         , Md          , Md          , Xu          , Xu          , Wot^Es      , Wot         , Wot^Em      , Xue         , Wwf^Br|     , Sm^Es       , Xu          , Xu          , Uu^Em       , Uu^Em       , Uh          , Uu          , Ur          , Uu          , Xu          , Xu          , Xu          , Ur          , Xu          , Xu          , Ur          , Ur          , Uu          , Xu          , Uu          , Uu          , Ur^Em       , Xu          , Uu^Em       , Xu          , Uu^Em       , Uu^Emf      , Xu          , Uu          , Uu          , Uu          , Xu          , Xu          , Ur^Em       , Uu^Vu       , Xu          , Xu          , Uu^Em       , Xu          , Xu          
Gs^Fdw      , Wwg         , Wwg         , Ss^Vhs      , Wwrg        , Ss          , Wwg         , Wwrg        , Ss          , Md          , Hhd^Fmw     , Md          , Hhd^Fmw     , Xu          , Wot         , Wot         , Wot^Em      , Sm^Br|      , Uh^Br\      , Uu^Vu       , Xu          , Uh^Em       , Ur          , Ur          , Xu          , Xu          , Uu          , Xu          , Uu^Vud      , Uu^Em       , Xu          , Ur          , Xu          , Uu^Uf       , Uu          , Xu          , Xu          , Uh          , Uu^Vu       , Xu          , Xu          , Xu          , Uu^Es       , Uu^Em       , Uu^Es       , Uu          , Ur          , Uu          , Uu^Em       , Uu          , Ur          , Xu          , Xu          , Xu          , Ur^Em       , Uu          , Ur^Em       , Uu^Uf       
Gs^Fdw      , Wwg         , Ds          , Wwg^Bw|r    , Wwg         , Wwg         , Ss          , Wwf         , Ds^Es       , Ds          , Hh^Fp       , Md          , Md          , Xu          , Wwr^Es      , Wo          , Wo^Es       , Xue         , Sm^Em       , Uu^Br|      , Xu          , Xu          , Uu          , Ur          , Xu          , Uu          , Uu          , Xu          , Xu          , Xu          , Uu^Uf       , Uu^Emf      , Xu          , Uh          , Ur          , Xu          , Uh^Emf      , Xu          , Xu          , Xu          , Uh^Es       , Xu          , Ur^Es       , Uu^Es       , Uu          , Ur          , Xu          , Xu          , Xu          , Xu          , Ur          , Xu          , Uu^Em       , Xu          , Ur          , Xu          , Uu^Vud      , Ur          
Gs^Fdw      , Gd^Es       , Ds^Es       , Ds          , Ss          , Gd^Fetd     , Ss          , Ds          , Wog         , Hhd^Fmw     , Wwg         , Hhd^Fmw     , Hh^Vhh      , Xu          , Xu          , Wwr         , Wwrg        , Wwrg        , Rb          , Rb^Br|      , Uu^Br\      , Xu          , Cud         , Uu          , 3 Kud       , Cud         , Cud         , Uu          , Uu          , Uu^Em       , Uu^Uf       , Xu          , Uu          , Ur          , Uh          , Uu          , Uu          , Uu^Em       , Uu^Es       , Uh^Es       , Ur^Es       , Ur^Es       , Urb^Emf     , Uu          , Xu          , Uu          , Ur          , Xu          , Ur          , Xu          , Xu          , Uu^Em       , Xu          , Ur          , Xu          , Xu          , Xu          , Uh          
Gll^Fp      , Gs^Fdw      , Gs^Fdw      , Re          , Re          , Gs          , Gg          , Gg          , Gd^Efm      , Wwg         , Wwrg        , Ss          , Md          , Xu          , Md          , Xu          , Xu          , Xu          , Urb         , Urb         , Urb^Br|     , Uu          , Ur          , Cud         , Xu          , Xu          , Uu          , Uu          , Ur          , Uh^Em       , Uh          , Uu          , Xu          , Xu          , Xu          , Uu^Uf       , Uu          , Uu          , Ur          , Uu          , Xuc         , Uu^Vu       , Xu          , Ql          , Xu          , Uh          , Xu          , Uu          , Xuc         , Ur          , Uu          , Xu          , Xu          , Ur          , Uu^Es       , Uu^Vu       , Xu          , Xu          
Gs^Fdw      , Gs^Fdw      , Gs^Eff      , Gs^Eff      , Gg^Eff      , Re          , Rb^Efm      , Gg^Efm      , Gg^Efm      , Wwg         , Wwrg        , Wwrg        , Wwg         , Hhd^Fdw     , Hhd^Fdw     , Md          , Rp^Vhcr     , Rr^Vd       , Uu^Vud      , Urb^Br/     , Xu          , Ur^Br\      , Uu^Br\      , Ur          , Uu          , Uu          , Uu          , Xuc         , Xuc         , Ur          , Uu          , Uu          , Xu          , Xu          , Xu          , Uu          , Xuc         , Ur          , Ur          , Cud         , Uu^Vud      , Xuc         , Xuc         , Xuc         , Xuc         , Xuc         , Xuc         , Xuc         , Cud         , Uu          , Uu          , Xu          , Uu          , Xu          , Ur          , Xu          , Uu^Es       , Ur^Es       
Gg^Gvs      , Gs^Vl       , Gll^Fp      , Gg^Eff      , Gg^Efm      , Re          , Rp          , Gg^Efm      , Wwrg        , Wwg         , Gs^Fdw      , Gs^Fdw      , Wog         , Wog         , Qxu         , Hhd^Fmf     , Rr          , Rr          , Uu^Vud      , Md          , Md          , Xu          , Xu          , Uu^Br\      , Uu          , Xu          , Xu          , Uu^Vud      , Xuc         , Uu          , Uu^Em       , Uu          , Ur          , Ur          , Uu          , Uu          , Xuc         , Cud         , Uu^Vud      , Ur          , Ur          , Rr^Vd       , Ur          , Rr^Vd       , Ur          , Rr^Vd       , Ur          , Uu          , Xuc         , Xuc         , Xuc         , Uu          , Ur          , Xu          , Uu          , Uu          , Qxu^Bs|     , Uh^Emf      
Gg^Gvs      , Gg^Gvs      , Gs^Eff      , Gg^Ve       , Hh^Fds      , Rb          , Rp          , Re          , Gg          , Wwg         , Wwg         , Gs^Fdw      , Wog         , Qxu         , Qxu^Bsb/    , Qxu^Bsb/    , Md          , Rp^Vhcr     , Md          , Md          , Md          , Md          , Xu          , Uu^Br|      , Uu          , Xu          , Uu^Vud      , Xu          , Xuc         , Ur          , Uu^Em       , Xuc         , Xuc         , Xuc         , Uu^Vu       , Ur          , Uu^Vu       , Xuc         , Ur          , Ur          , Xuc         , Ur          , Rr^Vd       , Ur          , Ur          , Ur          , Ur          , Ur          , Ur          , Uu^Vu       , Xuc         , Xuc         , Ur          , Uu          , Uh          , Qxu         , Qxu^Bs|     , Qxu         
Gg^Efm      , Gg^Eff      , Gd^Fmw      , Gs^Fdw      , Gs^Fdw      , Gg          , Rp          , Rb          , Gs^Fdw      , Wwg         , Wwrg        , Wwg         , Wog^Bsb/    , Qxu^Bsb/    , Qxu         , Qxu         , Ss          , Md          , Hhd^Fmf     , Md          , Md          , Md          , Xu          , Uu^Br|      , Xu          , Uu          , Xuc         , Xuc         , Uu^Es       , Ur          , Ur          , Xuc         , Xuc         , Xuc         , Xuc         , Uh^Emf      , Xuc         , Xuc         , Ur          , Rr^Vd       , Kud         , Ur          , Ur          , Ur          , Ur          , Rr^Vd       , Xuc         , Ur          , Ur          , Xuc         , Uu^Vud      , Xuc         , Uu          , Uu^Uf       , Xuc         , Qxu         , Uu^Em       , Xu          
Gg          , Gd^Fmw      , Gs^Fdw      , Gd^Fmw      , Gs^Fdw      , Gd^Fetd     , Rr          , Rp          , Gs^Fdw      , Gs^Fdw      , Gs^Fdw      , Rp          , Gs^Fms      , Wog         , Wog         , Wwrg        , Wog         , Hhd^Fmw     , Hhd^Fmw     , Hhd^Fmf     , Xu          , Xu          , Uh          , Uu^Br|      , Uu^Br\      , Xu          , Rr^Vd       , Uu^Es       , Ur          , Uu          , Xuc         , Cud         , Ur          , Uu^Vud      , Xuc         , Xuc         , Xuc         , Ur          , Xuc         , Ur          , Urb         , Cud         , Kud         , Ur          , Cud         , Urb         , Kud         , Ur          , Rr^Vd       , Ur          , Uu^Vud      , Cud         , Uu          , Uu^Uf       , Xuc         , Uu^Emf      , Xu          , Xu          
Gs^Fdw      , Gs^Fdw      , Gs^Fdw      , Gs^Fdw      , Rp          , Rp          , Rp          , Rr          , Rp          , Gd          , Rp          , Rp          , Wog         , Wog         , Wwrg        , Wog         , Hh^Fp       , Uu^Vu       , Wwf         , Md          , Md          , Xu          , Uu^Uf       , Ur          , Uu^Br|      , Xu          , Uu^Vu       , Ur          , Ur          , Xuc         , Uu^Vud      , Uu^Uf       , Ur          , Uu^Uf       , Ur          , Xuc         , Xuc         , Ur          , Ur          , Ur          , Cud         , Cud         , Urb         , Cud         , Urb         , Cud         , Ur          , Ur          , Ur          , Ur          , Xuc         , Xuc         , Uu^Em       , Uu^Em       , Xuc         , Uh^Em       , Uu^Em       , Xu          
Gs^Fdw      , Gd^Fmw      , Rp          , Cv^Efm      , 1 Kv        , Cv^Efm      , Cv^Efm      , Cv^Efm      , Gg^Efm      , Rp          , Gg^Ve       , Gd          , Wog         , Gd^Fetd     , Wog         , Md          , Md          , Md          , Mm^Xm       , Md          , Md          , Xu          , Uu          , Ur          , Uu^Br|      , Xu          , Xu          , Uu^Es       , Uu^Es       , Xuc         , Xuc         , Xuc         , Xuc         , Ur          , Cud         , Uu^Uf       , Ur          , Ur          , Rr^Vhc      , Ur          , Ur          , Ur          , Xuc         , Ur          , Ur          , Ur          , Ur          , Ur          , Uu^Vud      , Cud         , Uue^Emf     , Uue^Emf     , Uu^Uf       , Xuc         , Xu          , Xu          , Uu^Emf      , Xu          
Gs^Fdw      , Gs^Fdw      , Rp          , Rp          , Rp          , Cv^Efm      , Cv^Efm      , Cv^Efm      , Gg^Efm      , Gs          , Gs^Fdw      , Gs^Fdw      , Wog^Bw/r    , Gll         , Wog^Bw\r    , Gd^Fmw      , Rb          , Mm^Xm       , Md          , Chr         , Re          , Rb          , Xu          , Uu          , Ur          , Uu^Br\      , Uu^Br\      , Xu          , Ur          , Xuc         , Uu^Vud      , Xuc         , Xuc         , Xuc         , Uu^Vud      , Ur          , Uu^Uf       , Uu^Em       , Cud         , Uu          , Cud         , Ur          , Ur          , Ur          , Uu^Vud      , Ur          , Uu          , Xuc         , Xuc         , Uue^Em      , Uue^Em      , Uh^Em       , Xuc         , Xuc         , Xu          , Xu          , Uue^Em      , Uu^Emf      
Gs^Fdw      , Rb          , Rp          , Rp          , Rb          , Rp          , Rp          , Rp          , Gs^Fdw      , Gg          , Gs^Fdw      , Gs          , Gs          , Wog         , Wog         , Re          , Md          , Re          , Rb          , Rb          , Re          , Gs^Fdw      , Gs^Fdw      , Xu          , Xu          , Ur          , Uu^Br|      , Xu          , Xu          , Uu^Es       , Uh          , Uh^Emf      , Xuc         , Uu^Br/      , Xuc         , Xuc         , Xuc         , Xuc         , Uu^Es       , Xuc         , Uu^Em       , Cud         , Xuc         , Uh          , Uh          , Uh          , Cud         , Xuc         , Uu^Em       , Uue^Em      , Uue^Emf     , Uue^Em      , Uue^Em      , Uue^Emf     , Uu^Uf       , Uue^Emf     , Uue^Emf     , Uue^Emf     
Rp          , Rp          , Gll^Fmf     , Wwrt        , Ww^Ewf      , Gs^Fdw      , Gg^Ve       , Rr          , Rr          , Gs^Fdw      , Gg          , Gg^Gvs      , Gs          , Wog         , Gg^Fet      , Wog         , Wog         , Hhd^Fmw     , Hhd^Fmw     , Gs^Fdw      , Gs^Fdw      , Gs^Fdw      , Gs^Fdw      , Xu          , Xu          , Uu^Uf       , Ur          , Uu^Br\      , Uu^Br\      , Uu          , Uu^Br/      , Xu          , Uu^Br/      , Uu^Br|      , Xuc         , Uu^Uf       , Uh^Em       , Uu          , Uh          , Uu^Em       , Uu^Emf      , Uu^Emf      , Uu^Vu       , Cud         , Xuc         , Xuc         , Uu^Emf      , Uu^Es       , Uu^Em       , Xuc         , Xuc         , Uu^Uf       , Uue         , Uue^Em      , Uue^Em      , Uue^Emf     , Uu^Uf       , Uh          
Rp          , Gll^Fmf     , Wot         , Ww          , Hh^Fp       , Ww^Vm       , Gg          , Rr          , Gg          , Gs^Fdw      , Gs^Fdw      , Gs^Fdw      , Wog         , Wog         , Hhd^Fdw     , Wog         , Hhd^Fdw     , Wog         , Gs^Fdw      , Gs^Fdw      , Gs^Fdw      , Gs^Fdw      , Xu          , Xu          , Uh          , Ur          , Xu          , Xu          , Xu          , Uu^Br/      , Xu          , Uu^Br\      , Xuc         , Xuc         , Uh          , Uu^Em       , Xu          , Xu          , Uu^Uf       , Xu          , Uu^Emf      , Uu^Emf      , Uu^Emf      , Xuc         , Uu^Uf       , Uu^Uf       , Uu^Emf      , Uh^Em       , Uh          , Uh          , Uu^Emf      , Uue^Emf     , Xu          , Uue^Emf     , Uue^Emf     , Uue^Emf     , Uue^Emf     , Uue^Emf     
