border_size=1
usage=map

Gll^Fmf     , Gll^Fmf     , Gll^Fmf     , Gll^Fmf     , Gll^Fmf     , Gll^Fmf     , Gll^Fmf     , Gll^Fmf     , Gll^Fmf     , Hh^Fp       , Hh^Fp       , Hh^Fp       , Mm          , Gs^Fms      , Mm          , Gs^Fms      , Gll^Fp      , Gs^Fms      , Gll^Fp      , Gll^Fmf     , Gll^Fmf     , Gll^Fmf     , Gll^Fmf     , Gll^Fmf     , Gll^Fmf     , Gll^Fmf     , Gll^Fmf     , Gll^Fmf     , Gll^Fmf     , Gll^Fmf     , Gll^Fmf     , Gll^Fmf     , Gll^Fmf     , Gll^Fmf     , Gll^Fmf     
Gll^Fmf     , Gll^Fmf     , 3 Kv        , Cv          , Gg^Efm      , Gg^Fet      , Gll^Fmf     , Gg^Ve       , Gll^Fmf     , Hh^Fp       , Hh^Vhh      , Mm          , Mm          , Mm          , Gll^Fp      , Hh^Vhh      , Gll^Fmf     , Gll^Fp      , Gll^Fmf     , Gll^Fmf     , Gll^Fmf     , Gll^Fmf     , Gll^Fmf     , Gll^Fmf     , Gll^Fmf     , Gll^Fmf     , Gll^Fmf     , Gg^Ve       , Gll^Fmf     , Gll^Fmf     , Gll^Fmf     , Gll^Fmf     , Gll^Fmf     , Gll^Fmf     , Gll^Fmf     
Gll^Fmf     , Cv          , Gg          , Cv^Efm      , Cv          , Gg^Efm      , Gs          , Gs          , Gs          , Gll^Fmf     , Hh^Fp       , Mm          , Mm          , Hhd^Fdf     , Hhd^Fdf     , Gll^Fp      , Gll^Fmf     , Gll^Fmf     , Gll^Fmf     , Gll^Fmf     , Gll^Fmf     , Gll^Fmf     , Gll^Fmf     , Gll^Fmf     , Gll^Fmf     , Gll^Fmf     , Gll^Fmf     , Gll^Fmf     , Gll^Fmf     , Gll^Fmf     , Gs^Efm      , Gll^Fmf     , Gll^Fmf     , Gll^Fmf     , Gll^Fmf     
Gll^Fmf     , Gll^Fmf     , Gs^Efm      , Gg          , Gll^Fmf     , Gll^Fmf     , Gll^Fmf     , Gll^Fmf     , Gll^Fmf     , Gs          , Gll^Fmf     , Hh^Fp       , Gll^Fmf     , Hhd^Fdf     , Gll^Fmf     , Gll^Fmf     , Gll^Fmf     , Gll^Fmf     , Gll^Fmf     , Gll^Fmf     , Gll^Fmf     , Gll^Fmf     , Gll^Fmf     , Gll^Fmf     , Gll^Fmf     , Gll^Fmf     , Gll^Fmf     , Gll^Fmf     , Gs          , Gd^Cov      , 4 Gg^Kov    , Gd^Cov      , Gs          , Gll^Fmf     , Gll^Fmf     
Gll^Fmf     , Gll^Fmf     , Gll^Fmf     , Gll^Fmf     , Gll^Fmf     , Gll^Fmf     , Gll^Fp      , Gll^Fmf     , Gll^Fmf     , Gs          , Gs          , Gll^Fmf     , Gll^Fmf     , Gll^Fmf     , Gll^Fmf     , Gd          , Gll^Fmf     , Gll^Fmf     , Gg          , Gll^Fmf     , Gll^Fmf     , Gll^Fmf     , Gd          , Gll^Fmf     , Gd^Fdf      , Gd^Fdf      , Gll^Fmf     , Gll^Fmf     , Gll^Fmf     , Gd^Cov      , Gs^Efm      , Gd^Cov      , Gll^Fmf     , Gll^Fmf     , Gll^Fmf     
Gll^Fmf     , Gg^Ve       , Hhd^Fdf     , Gll^Fmf     , Gll^Fmf     , Gll^Fmf     , Hh^Fp       , Gll^Fmf     , Hh          , Gll^Fmf     , Gll^Fmf     , Gs          , Gd          , Gll^Fmf     , Gd          , Gd          , Gll^Fmf     , Gll^Fmf     , Gll^Fmf     , Gll^Fmf     , Gll^Fmf     , Gll^Fmf     , Gll^Fmf     , Gd          , Gll^Fmf     , Gd^Fdf      , Gd^Fdf      , Gd^Fdf      , Gd^Fdf      , Gll^Fmf     , Gg          , Gll^Fmf     , Gll^Fmf     , Gll^Fmf     , Gll^Fmf     
Gll^Fmf     , Gll^Fmf     , Hhd^Fdf     , Hhd^Fdf     , Hh^Fp       , Gll^Fmf     , Mm          , Gll^Fmf     , Hhd^Fdf     , Gll^Fmf     , Gll^Fmf     , Gs          , Gd          , Gd          , Gd          , Gll^Fmf     , Gll^Fmf     , Gll^Fmf     , Gll^Fmf     , Gll^Fmf     , Gll^Fmf     , Gll^Fmf     , Gll^Fmf     , Gll^Fmf     , Gll^Fmf     , Gll^Fmf     , Gll^Fmf     , Gll^Fmf     , Gll^Fmf     , Gll^Fmf     , Gll^Fmf     , Gg          , Gll^Fp      , Gg^Ve       , Gll^Fp      
Mm          , Mm          , Mm          , Mm          , Mm          , Mm          , Mm          , Mm          , Gll^Fmf     , Hhd^Fdf     , Gg          , Gs          , Gll^Fmf     , Gll^Fmf     , Gll^Fmf     , Gd          , Gd          , Gll^Fmf     , Gg^Ve       , Gg          , Gll^Fmf     , Gll^Fmf     , Gll^Fmf     , Gll^Fmf     , Gll^Fmf     , Gll^Fmf     , Gll^Fmf     , Gs          , Gs          , Gs          , Gs          , Gll^Fmf     , Gll^Fmf     , Gll^Fp      , Gll^Fmf     
Md          , Md          , Hhd^Fdf     , Hh^Fp       , Hhd^Fdf     , Hh          , Hh^Vhh      , Hh          , Gll^Fmf     , Gll^Fmf     , Gll^Fp      , Cv          , Cv          , Gg          , Cv          , Cv          , Gll^Fmf     , Gll^Fmf     , Gll^Fmf     , Gll^Fmf     , Gll^Fmf     , Gll^Fmf     , Hhd^Fdf     , Hhd^Fdf     , Hhd^Fdf     , Gll^Fmf     , Gll^Fmf     , Gll^Fmf     , Gll^Fmf     , Gll^Fmf     , Gll^Fmf     , Gll^Fmf     , Gll^Fmf     , Gll^Fmf     , Gll^Fmf     
Md          , Hh^Fp       , Hhd^Fdf     , Hhd^Fdf     , Hh^Fp       , Hhd^Fdf     , Gll^Fmf     , Gll^Fmf     , Gll^Fmf     , Gll^Fp      , Gll^Fp      , Cv          , Wwt         , 2 Kv^Efm    , Gg          , Gll^Fmf     , Gll^Fmf     , Gg          , Gll^Fmf     , Gll^Fmf     , Gll^Fmf     , Gll^Fmf     , Hhd^Fdf     , Hhd^Fdf     , Hhd^Fdf     , Gll^Fmf     , Hhd^Fdf     , Gll^Fmf     , Gll^Fmf     , Gll^Fmf     , Gll^Fmf     , Gll^Fmf     , Gll^Fmf     , Gll^Fmf     , Gll^Fmf     
Md          , Hh^Fp       , Gll^Fmf     , Hh          , Gll^Fmf     , Hhd^Fdf     , Gll^Fmf     , Gs          , Gs          , Gs          , Gll^Fmf     , Cv          , Cv          , Cv          , Gll^Fmf     , Gg^Efm      , Gs          , Gll^Fmf     , Gll^Fmf     , Gll^Fmf     , Gll^Fmf     , Gd^Fdf      , Gd^Fdf      , Gd^Fdf      , Gll^Fmf     , Hhd^Fdf     , Gll^Fmf     , Gll^Fp      , Gll^Fmf     , Gll^Fmf     , Gll^Fmf     , Gll^Fmf     , Gd          , Gll^Fmf     , Gll^Fmf     
Mm^Xm       , Md          , Md          , Gll^Fmf     , Gll^Fmf     , Gll^Fmf     , Gll^Fmf     , Gll^Fmf     , Gll^Fmf     , Gll^Fmf     , Gll^Fmf     , Gll^Fmf     , Gll^Fmf     , Gll^Fmf     , Gll^Fmf     , Gll^Fmf     , Gll^Fmf     , Gll^Fmf     , Gll^Fmf     , Gll^Fmf     , Gs          , Gd^Fdf      , Gll^Fmf     , Gd^Fdf      , Gll^Fmf     , Gll^Fmf     , Gll^Fmf     , Gll^Fmf     , Gll^Fp      , Gll^Fmf     , Gd          , Gd          , Gd          , Gll^Fmf     , Gll^Fmf     
Mm^Xm       , Md          , Md          , Hh          , Gll^Fmf     , Gll^Fmf     , Gs          , Gll^Fmf     , Hhd^Fdf     , Gll^Fmf     , Gll^Fmf     , Gll^Fmf     , Gll^Fmf     , Gll^Fmf     , Gll^Fmf     , Gll^Fmf     , Gll^Fmf     , Gll^Fmf     , Gll^Fmf     , Gs          , Gs          , Gll^Fmf     , Gs          , Gll^Fmf     , Gll^Fmf     , Gll^Fmf     , Gll^Fmf     , Gll^Fmf     , Gll^Fmf     , Gll^Fmf     , Gll^Fmf     , Gll^Fmf     , Gll^Fmf     , Gll^Fmf     , Gll^Fmf     
Md          , Md          , Hh^Fp       , Hh^Fp       , Hh^Fp       , Gll^Fmf     , Gll^Fmf     , Gll^Fmf     , Gll^Fmf     , Gll^Fmf     , Gll^Fmf     , Gll^Fmf     , Gg^Ve       , Gll^Fmf     , Gs          , Gll^Fmf     , Gll^Fmf     , Gll^Fmf     , Gll^Fmf     , Gs          , Gll^Fmf     , Gs          , Gll^Fmf     , Gs          , Gs          , Gll^Fmf     , Gll^Fmf     , Gll^Fmf     , Gll^Fp      , Gll^Fmf     , Gll^Fmf     , Gll^Fmf     , Gll^Fmf     , Gll^Fmf     , Gll^Fmf     
Hh^Fp       , Md          , Md          , Gs^Fms      , Hh^Fp       , Gll^Fmf     , Gll^Fmf     , Gll^Fmf     , Gll^Fmf     , Gd          , Gd          , Gll^Fmf     , Gll^Fmf     , Gs          , Gll^Fmf     , Gll^Fmf     , Gll^Fmf     , Gll^Fmf     , Gll^Fmf     , Gll^Fmf     , Gll^Fmf     , Gll^Fmf     , Gll^Fmf     , Gll^Fmf     , Gll^Fmf     , Gs          , Gs          , Gs          , Gs          , Gs          , Gs          , Gs          , Gll^Fmf     , Gll^Fmf     , Gll^Fmf     
Hh^Fp       , Hh^Fp       , Hhd^Vhhr    , Hh^Fp       , Gll^Fmf     , Gll^Fmf     , Gs^Efm      , Gs^Efm      , Gll^Fmf     , Gll^Fmf     , Gd          , Gll^Fmf     , Gll^Fmf     , Gll^Fmf     , Gll^Fmf     , Gll^Fmf     , Gll^Fmf     , Gll^Fmf     , Gs^Gvs      , Gll         , Gg^Efm      , Gll^Fmf     , Gll^Fmf     , Gll^Fmf     , Gs          , Gs          , Gll^Fmf     , Gll^Fmf     , Gll^Fmf     , Gll^Fmf     , Gll^Fmf     , Gll^Fmf     , Gll^Fmf     , Gll^Fmf     , Gll^Fmf     
Hh^Fp       , Hh^Fp       , Hh^Fp       , Hh^Fp       , Gll^Fmf     , Gll^Fmf     , Hh^Fp       , Hh^Fp       , Md          , Hh          , Hhd^Fdf     , Gll^Fmf     , Gll^Fmf     , Gll^Fmf     , Gll^Fmf     , Gll^Fmf     , Gs^Eff      , Gs^Gvs      , Gs          , Gg^Efm      , Gll^Fmf     , Gll^Fmf     , Gs          , Gs          , Gll^Fmf     , Gll^Fmf     , Gg          , Gll^Fmf     , Gs          , Gll^Fmf     , Gll^Fmf     , Gll^Fmf     , Gll^Fmf     , Gll^Fmf     , Gll^Fmf     
Gll^Fmf     , Gll^Fmf     , Gll^Fmf     , Gs          , Gll^Fmf     , Gll^Fmf     , Hh^Fp       , Hh^Fp       , Mm^Xm       , Mm^Xm       , Hh          , Gll^Fmf     , Gll^Fmf     , Gll^Fmf     , Gs^Eff      , Gs^Eff      , Gs^Gvs      , Gs^Eff      , Gs^Eff      , Gll^Fmf     , Gll^Fmf     , Gll^Fmf     , Gs          , Gs          , Gs          , Gll^Fmf     , Gll^Fmf     , Gll^Fmf     , Gs          , Gs          , Gs          , Gll^Fmf     , Gll^Fmf     , Gll^Fmf     , Gll^Fmf     
Gll^Fmf     , Gll^Fmf     , Gd^Fdf      , Gll^Fmf     , Gll^Fmf     , Gll^Fmf     , Gll^Fmf     , Md          , Md          , Mm^Xm       , Hh^Fp       , Gd^Fdf      , Gd^Fdf      , Gs^Eff      , Gs^Eff      , Gs^Gvs      , Gs^Gvs      , Gs^Gvs      , Gs          , Gg^Ve       , Re          , Gs          , Gd^Fdf      , Gs          , Gs          , Gll^Fmf     , Gll^Fmf     , Gll^Fmf     , Gll^Fmf     , Gll^Fmf     , Gs          , Gs          , Gll         , Gll^Fmf     , Gll^Fmf     
Gll^Fmf     , Gll^Fmf     , Gll^Fmf     , Gd^Fdf      , Gd^Fdf      , Gll^Fmf     , Hh^Fp       , Hh^Fp       , Hh^Fp       , Md          , Hh^Wm       , Gll^Fmf     , Gll^Fmf     , Gd^Fdf      , Gll^Fmf     , Gg^Ve       , Re          , Re          , Re          , Re          , Gll^Fmf     , Gll^Fmf     , Gd^Fdf      , Gd^Fdf      , Gll^Fmf     , Gd^Fdf      , Gll^Fmf     , Gll^Fmf     , Gs          , Gs          , Gll^Fmf     , Gs          , Gll^Fmf     , Gll^Fmf     , Gll^Fmf     
Gll^Fp      , Gs          , Gd          , Gd          , Gll^Fmf     , Gll^Fmf     , Gll^Fmf     , Hh^Fp       , Hh^Fp       , Hh^Vhh      , Gll^Fmf     , Gll^Fmf     , Gll^Fmf     , Gll^Fmf     , Gll^Fmf     , Gs          , Re          , Ww          , Ww          , Ww          , Ww          , Ww          , Hh          , Gll^Fmf     , Gll^Fmf     , Gg          , Hhd^Fmf     , Gs          , Hhd^Fmf     , Gs          , Gll^Fmf     , Gll^Fmf     , Gll^Fmf     , Gll^Fmf     , Gll^Fmf     
Gll^Fp      , Gll^Fp      , Gll^Fmf     , Gll^Fmf     , Gll^Fmf     , Gll^Fmf     , Gs^Efm      , Gs          , Hhd^Fdf     , Gs          , Gll^Fmf     , Gll^Fmf     , Gs          , Gll^Fmf     , Ww          , Gll^Fmf     , Ww          , Ww          , Ww          , Ww          , Gll^Fmf     , Mm          , Hhd^Fdf     , Mm          , Hhd^Fmf     , Hhd^Fmf     , Hhd^Fmf     , Hh          , Gll^Fmf     , Gll^Fmf     , Gll^Fmf     , Gg          , Hhd^Fmf     , Gll^Fmf     , Gll^Fmf     
Gll^Fmf     , Gll^Fmf     , Gs          , Gll^Fmf     , Gg^Fet      , Gll^Fmf     , Gll^Fmf     , Gll^Fmf     , Gll^Fmf     , Gll^Fmf     , Mm          , Ww          , Ww          , Ww          , Ww          , Ww          , Wo          , Ww          , Ww          , Wwr         , Hhd^Fdf     , Hhd^Fmf     , Hhd^Fdf     , Gll^Fmf     , Gg          , Gll^Fp      , Gll^Fp      , Gll^Fmf     , Gll^Fmf     , Gll^Fmf     , Gll^Fmf     , Hhd^Fmf     , Hhd^Fmf     , Hh          , Hh          
Gll^Fmf     , Gll^Fmf     , Gll^Fmf     , Gll^Fmf     , Mm          , Mm          , Mm          , Mm          , Hh^Fp       , Mm          , Mm          , Ww          , Ww          , Gll^Fmf     , Wo          , Wo          , Wo          , Wo          , Ww          , Wwr         , Gll^Fmf     , Hhd^Fdf     , Gll^Fmf     , Gll^Fp      , Gll^Fmf     , Gg          , Gg          , Gg          , Gll^Fp      , Gg          , Hhd^Fmf     , Hhd^Fmf     , Gg          , Hhd^Fmf     , Gll^Fmf     
Gll^Fmf     , Re          , Hhd^Fdf     , Mm          , Mm          , Mm          , Mm          , Hh^Fp       , Mm^Xm       , Mm^Xm       , Mm^Xm       , Mm          , Ww          , Ww          , Ww          , Wo          , Wo          , Wo          , Ww^Vm       , Gll^Fmf     , Gll^Fmf     , Gll^Fmf     , Gll^Fmf     , Hh          , Gll^Fmf     , Hhd^Fmf     , Gll^Fmf     , Gll^Fmf     , Gll^Fmf     , Gll^Fmf     , Gll^Fmf     , Gg          , Gg          , Gg          , Gll^Fmf     
Gll^Fmf     , Hhd^Fdf     , Mm^Xm       , Mm          , Mm          , Mm          , Mm          , Md          , Mm          , Mm^Xm       , Mm          , Gll^Fmf     , Gs^Efm      , Gg^Fet      , Wo          , Wo          , Ww          , Ww          , Gll^Fmf     , Gll^Fmf     , Gll^Fmf     , Gll^Fmf     , Gd          , Gd          , Gll^Fmf     , Gg          , Gll^Fmf     , Gll^Fmf     , Gll^Fmf     , Gll^Fmf     , Gll^Fmf     , Gg          , Gll^Fmf     , Gs^Vc       , Gll^Fmf     
Gll^Fmf     , Gll^Fmf     , Gll^Fmf     , Ch          , 5 Kh        , Mm          , Hhd^Fmf     , Hhd^Fmf     , Hhd^Fmf     , Hhd^Fmf     , Hhd^Fmf     , Gll^Fmf     , Gll^Fmf     , Wo          , Gll^Fmf     , Ww          , Gll^Fmf     , Gll^Fmf     , Gll^Fmf     , Gll^Fmf     , Gll^Fmf     , Gll^Fmf     , Gll^Fmf     , Gll^Fmf     , Gll^Fmf     , Gll^Fmf     , Gll^Fmf     , Gll^Fmf     , Gs          , Gll^Fmf     , Gs          , Gll^Fmf     , Gll^Fmf     , Gll^Fmf     , Gll^Fmf     
Gll^Fmf     , Gg^Ve       , Hhd^Fdf     , Ch          , Ch          , Ch          , Rb          , Hh^Vhh      , Hh          , Hhd^Fmf     , Hhd^Fmf     , Hhd^Fmf     , Ww          , Wo          , Gll^Fmf     , Gll^Fmf     , Hh^Vhh      , Gll^Fmf     , Gll^Fmf     , Gll^Fmf     , Gll^Fmf     , Gll^Fmf     , Gs          , Gll^Fmf     , Gll^Fmf     , Gs          , Gs          , Gs          , Gll^Fmf     , Gs          , Gll^Fmf     , Gll^Fmf     , Gg          , Gll^Fmf     , Gll^Fmf     
Gll^Fmf     , Gll^Fmf     , Gll^Fmf     , Gll^Fmf     , Gd^Fdf      , Hhd^Fmf     , Hh          , Rb          , Gs          , Hhd^Fmf     , Hhd^Fmf     , Gll^Fmf     , Wo          , Wo          , Md          , Gll^Fmf     , Hh^Fp       , Hhd^Fdf     , Hhd^Fdf     , Gll^Fmf     , Gll^Fmf     , Gll^Fmf     , Gll^Fmf     , Gll^Fmf     , Gll^Fmf     , Gll^Fmf     , Gll^Fmf     , Gll^Fmf     , Gll^Fmf     , Gll^Fmf     , Gll^Fmf     , Gll^Fmf     , Gll^Fmf     , Gg          , Gll^Fmf     
Gll^Fmf     , Gll^Fmf     , Gll^Fmf     , Gd^Fdf      , Gll^Fmf     , Gd^Fdf      , Gll^Fmf     , Gd          , Gll^Fmf     , Hhd^Fmf     , Gll^Fmf     , Ww          , Wo          , Md          , Md          , Hh^Fp       , Md          , Hh^Fp       , Hh          , Gll^Fmf     , Hhd^Fdf     , Gll^Fmf     , Gs^Vc       , Gll^Fmf     , Gll^Fmf     , Gll^Fmf     , Gll^Fmf     , Gll^Fmf     , Gd          , Gll^Fmf     , Gd          , Gll^Fmf     , Gll^Fmf     , Gll^Fmf     , Gll^Fmf     
Gll^Fmf     , Gll^Fmf     , Ss          , Ss          , Gll^Fmf     , Ss          , Gll^Fmf     , Gs          , Gd          , Gd          , Ww^Bw\      , Ww          , Wo          , Wo          , Gll^Fmf     , Md          , Md          , Md          , Hh^Fp       , Hh^Fp       , Hh^Fp       , Hh          , Gll^Fmf     , Gll^Fmf     , Gll^Fmf     , Gll^Fmf     , Gd          , Gd          , Ce          , Gd          , Gll         , Gs^Vh       , Gll^Fmf     , Gll^Fmf     , Gll^Fmf     
Gll^Fmf     , Gll^Fmf     , Ss          , Wwg         , Wwf         , Gll^Fmf     , Gll^Fmf     , Gll^Fmf     , Gll^Fmf     , Gll^Fmf     , Ww          , Ww^Bw\      , Gll^Fmf     , Ww          , Ww^Vm       , Gll^Fmf     , Md          , Md          , Gll^Fmf     , Hhd^Fdf     , Hh          , Hh          , Gll^Fmf     , Gll^Fmf     , Gd          , Gd          , Gd          , Ce          , 1 Ket       , Ce          , Rb          , Gd          , Gd          , Gll^Fmf     , Gll^Fmf     
Ss          , Ss          , Wwf         , Ss^Vhs      , Ww          , Gll^Fmf     , Ww          , Gll^Fmf     , Ww          , Ww          , Ww          , Wo          , Wo          , Ww^Bw\      , Ww^Bw\      , Gll^Fmf     , Md          , Gll^Fmf     , Gll^Fmf     , Gll^Fmf     , Gll^Fmf     , Gll^Fmf     , Gll^Fmf     , Gll^Fmf     , Gs^Gvs      , Gg^Gvs      , Gd          , Ce          , Ce          , Rb          , Gd          , Rb          , Rb          , Gll^Fmf     , Gll^Fmf     
Gs^Fms      , Ss          , Ww          , Ww          , Ww          , Ww          , Wwg         , Ww          , Wwr         , Wo          , Wo          , Wo          , Wo          , Wo          , Ww          , Rb          , Re          , Gs          , Gs          , Gd          , Gd          , Rb          , Rb          , Gll         , Gs^Vh       , Gs^Gvs      , Gll^Fmf     , Gd          , Gll^Fmf     , Gd          , Gll^Fmf     , Gll^Fmf     , Rb          , Gll^Fmf     , Gll^Fmf     
Gs^Fms      , Ww          , Ww          , Wwrg        , Ss          , Wwg         , Wwf         , Ss          , Ss          , Ss          , Ss          , Wo          , Wo          , Wo          , Ww          , Ww          , Hh          , Hh          , Gll^Fmf     , Gll^Fmf     , Gll^Fmf     , Gll^Fmf     , Gll^Fmf     , Gll^Fmf     , Gs^Gvs      , Gs^Gvs      , Gs^Gvs      , Gll^Fmf     , Gll^Fmf     , Gll^Fmf     , Gll^Fmf     , Gll^Fmf     , Rb          , Rb          , Gll^Fmf     
