border_size=1
usage=map

Gs^Fms      , Gs^Fms      , Gs^Fms      , Gs^Fms      , Gs^Fms      , Gs^Fms      , Gs^Fms      , Gs^Fms      , Gs^Fms      , Hh^Fp       , Hh^Fp       , Hh^Fp       , Mm          , Gs^Fms      , Mm          , Gs^Fms      , Gll^Fp      , Gs^Fms      , Gll^Fp      , Gs^Fms      , Gs^Fms      , Gs^Fms      , Gs^Fms      , Gs^Fms      , Gs^Fms      , Gs^Fms      , Gs^Fms      , Gs^Fms      , Gs^Fms      , Gs^Fms      , Gs^Fms      , Gs^Fms      , Gs^Fms      , Gs^Fms      , Gs^Fms      
Gs^Fms      , Gs^Fms      , 3 Kv        , Cv          , Gg^Efm      , Gg^Fet      , Gs^Fms      , Gg^Ve       , Gs^Fms      , Hh^Fp       , Hh^Vhh      , Mm          , Mm          , Mm          , Gll^Fp      , Hh^Vhh      , Gs^Fms      , Gll^Fp      , Gs^Fms      , Gs^Fms      , Gs^Fms      , Gs^Fms      , Gs^Fms      , Gs^Fms      , Gs^Fms      , Gs^Fms      , Gs^Fms      , Gg^Ve       , Gs^Fms      , Gs^Fms      , Gs^Fms      , Gs^Fms      , Gs^Fms      , Gs^Fms      , Gs^Fms      
Gs^Fms      , Cv          , Gg          , Cv^Efm      , Cv          , Gg^Efm      , Gs          , Gs          , Gs          , Gs^Fms      , Hh^Fp       , Mm          , Mm          , Hh^Fds      , Hh^Fds      , Gll^Fp      , Gs^Fms      , Gs^Fms      , Gs^Fms      , Gs^Fms      , Gs^Fms      , Gs^Fms      , Gs^Fms      , Gs^Fms      , Gs^Fms      , Gs^Fms      , Gs^Fms      , Gs^Fms      , Gs^Fms      , Gs^Fms      , Gs^Efm      , Gs^Fms      , Gs^Fms      , Gs^Fms      , Gs^Fms      
Gs^Fms      , Gs^Fms      , Gs^Efm      , Gg          , Gs^Fms      , Gs^Fms      , Gs^Fms      , Gs^Fms      , Gs^Fms      , Gs          , Gs^Fms      , Hh^Fp       , Gs^Fms      , Hh^Fds      , Gs^Fms      , Gs^Fms      , Gs^Fms      , Gs^Fms      , Gs^Fms      , Gs^Fms      , Gs^Fms      , Gs^Fms      , Gs^Fms      , Gs^Fms      , Gs^Fms      , Gs^Fms      , Gs^Fms      , Gs^Fms      , Gs          , Gd^Cov      , 4 Gg^Kov    , Gd^Cov      , Gs          , Gs^Fms      , Gs^Fms      
Gs^Fms      , Gs^Fms      , Gs^Fms      , Gs^Fms      , Gs^Fms      , Gs^Fms      , Gll^Fp      , Gs^Fms      , Gs^Fms      , Gs          , Gs          , Gs^Fms      , Gs^Fms      , Gs^Fms      , Gs^Fms      , Gg          , Gs^Fms      , Gs^Fms      , Gg          , Gs^Fms      , Gs^Fms      , Gs^Fms      , Gg          , Gs^Fms      , Gs^Fds      , Gs^Fds      , Gs^Fms      , Gs^Fms      , Gs^Fms      , Gd^Cov      , Gs^Efm      , Gd^Cov      , Gs^Fms      , Gs^Fms      , Gs^Fms      
Gs^Fms      , Gg^Ve       , Hh^Fds      , Gs^Fms      , Gs^Fms      , Gs^Fms      , Hh^Fp       , Gs^Fms      , Hh          , Gs^Fms      , Gs^Fms      , Gs          , Gg          , Gs^Fms      , Gg          , Gg          , Gs^Fms      , Gs^Fms      , Gs^Fms      , Gs^Fms      , Gs^Fms      , Gs^Fms      , Gs^Fms      , Gg          , Gs^Fms      , Gs^Fds      , Gs^Fds      , Gs^Fds      , Gs^Fds      , Gs^Fms      , Gg          , Gs^Fms      , Gs^Fms      , Gs^Fms      , Gs^Fms      
Gs^Fms      , Gs^Fms      , Hh^Fds      , Hh^Fds      , Hh^Fp       , Gs^Fms      , Mm          , Gs^Fms      , Hh^Fds      , Gs^Fms      , Gs^Fms      , Gs          , Gg          , Gg          , Gg          , Gs^Fms      , Gs^Fms      , Gs^Fms      , Gs^Fms      , Gs^Fms      , Gs^Fms      , Gs^Fms      , Gs^Fms      , Gs^Fms      , Gs^Fms      , Gs^Fms      , Gs^Fms      , Gs^Fms      , Gs^Fms      , Gs^Fms      , Gs^Fms      , Gg          , Gll^Fp      , Gg^Ve       , Gll^Fp      
Mm          , Mm          , Mm          , Mm          , Mm          , Mm          , Mm          , Mm          , Gs^Fms      , Hh^Fds      , Gg          , Gs          , Gs^Fms      , Gs^Fms      , Gs^Fms      , Gg          , Gg          , Gs^Fms      , Gg^Ve       , Gg          , Gs^Fms      , Gs^Fms      , Gs^Fms      , Gs^Fms      , Gs^Fms      , Gs^Fms      , Gs^Fms      , Gg          , Gg          , Gg          , Gg          , Gs^Fms      , Gs^Fms      , Gll^Fp      , Gs^Fms      
Md          , Md          , Hh^Fds      , Hh^Fp       , Hh^Fds      , Hh          , Hh^Vhh      , Hh          , Gs^Fms      , Gs^Fms      , Gll^Fp      , Cv          , Cv          , Gg          , Cv          , Cv          , Gs^Fms      , Gs^Fms      , Gs^Fms      , Gs^Fms      , Gs^Fms      , Gs^Fms      , Hh^Fds      , Hh^Fds      , Hh^Fds      , Gs^Fms      , Gs^Fms      , Gs^Fms      , Gs^Fms      , Gs^Fms      , Gs^Fms      , Gs^Fms      , Gs^Fms      , Gs^Fms      , Gs^Fms      
Md          , Hh^Fp       , Hh^Fds      , Hh^Fds      , Hh^Fp       , Hh^Fds      , Gs^Fms      , Gs^Fms      , Gs^Fms      , Gll^Fp      , Gll^Fp      , Cv          , Wwt         , 2 Kv^Efm    , Gg          , Gs^Fms      , Gs^Fms      , Gg          , Gs^Fms      , Gs^Fms      , Gs^Fms      , Gs^Fms      , Hh^Fds      , Hh^Fds      , Hh^Fds      , Gs^Fms      , Hh^Fds      , Gs^Fms      , Gs^Fms      , Gs^Fms      , Gs^Fms      , Gs^Fms      , Gs^Fms      , Gs^Fms      , Gs^Fms      
Md          , Hh^Fp       , Gs^Fms      , Hh          , Gs^Fms      , Hh^Fds      , Gs^Fms      , Gs          , Gs          , Gs          , Gs^Fms      , Cv          , Cv          , Cv          , Gs^Fms      , Gg^Efm      , Gs          , Gs^Fms      , Gs^Fms      , Gs^Fms      , Gs^Fms      , Gs^Fds      , Gs^Fds      , Gs^Fds      , Gs^Fms      , Hh^Fds      , Gs^Fms      , Gll^Fp      , Gs^Fms      , Gs^Fms      , Gs^Fms      , Gs^Fms      , Gg          , Gs^Fms      , Gs^Fms      
Mm^Xm       , Md          , Md          , Gs^Fms      , Gs^Fms      , Gs^Fms      , Gs^Fms      , Gs^Fms      , Gs^Fms      , Gs^Fms      , Gs^Fms      , Gs^Fms      , Gs^Fms      , Gs^Fms      , Gs^Fms      , Gs^Fms      , Gs^Fms      , Gs^Fms      , Gs^Fms      , Gs^Fms      , Gs          , Gs^Fds      , Gs^Fms      , Gs^Fds      , Gs^Fms      , Gs^Fms      , Gs^Fms      , Gs^Fms      , Gll^Fp      , Gs^Fms      , Gg          , Gg          , Gg          , Gs^Fms      , Gs^Fms      
Mm^Xm       , Md          , Md          , Hh          , Gs^Fms      , Gs^Fms      , Gs          , Gs^Fms      , Gs^Fds      , Gs^Fms      , Gs^Fms      , Gs^Fms      , Gs^Fms      , Gs^Fms      , Gs^Fms      , Gs^Fms      , Gs^Fms      , Gs^Fms      , Gs^Fms      , Gs          , Gs          , Gs^Fms      , Gs          , Gs^Fms      , Gs^Fms      , Gs^Fms      , Gs^Fms      , Gs^Fms      , Gs^Fms      , Gs^Fms      , Gs^Fms      , Gs^Fms      , Gs^Fms      , Gs^Fms      , Gs^Fms      
Md          , Md          , Hh^Fp       , Hh^Fp       , Hh^Fp       , Gs^Fms      , Gs^Fms      , Gs^Fms      , Gs^Fms      , Gs^Fms      , Gs^Fms      , Gs^Fms      , Gg^Ve       , Gs^Fms      , Gg          , Gs^Fms      , Gs^Fms      , Gs^Fms      , Gs^Fms      , Gs          , Gs^Fms      , Gs          , Gs^Fms      , Gs          , Gs          , Gs^Fms      , Gs^Fms      , Gs^Fms      , Gll^Fp      , Gs^Fms      , Gs^Fms      , Gs^Fms      , Gs^Fms      , Gs^Fms      , Gs^Fms      
Hh^Fp       , Md          , Md          , Gs^Fms      , Hh^Fp       , Gs^Fms      , Gs^Fms      , Gs^Fms      , Gs^Fms      , Gg          , Gg          , Gs^Fms      , Gs^Fms      , Gg          , Gs^Fms      , Gs^Fms      , Gs^Fms      , Gs^Fms      , Gs^Fms      , Gs^Fms      , Gs^Fms      , Gs^Fms      , Gs^Fms      , Gs^Fms      , Gs^Fms      , Gs          , Gs          , Gs          , Gs          , Gs          , Gs          , Gs          , Gs^Fms      , Gs^Fms      , Gs^Fms      
Hh^Fp       , Hh^Fp       , Hhd^Vhhr    , Hh^Fp       , Gs^Fms      , Gs^Fms      , Gs^Efm      , Gs^Efm      , Gs^Fms      , Gs^Fms      , Gg          , Gs^Fms      , Gs^Fms      , Gs^Fms      , Gs^Fms      , Gs^Fms      , Gs^Fms      , Gs^Fms      , Gs^Gvs      , Gs^Efm      , Gg^Efm      , Gs^Fms      , Gs^Fms      , Gs^Fms      , Gs          , Gs          , Gs^Fms      , Gs^Fms      , Gs^Fms      , Gs^Fms      , Gs^Fms      , Gs^Fms      , Gs^Fms      , Gs^Fms      , Gs^Fms      
Hh^Fp       , Hh^Fp       , Hh^Fp       , Hh^Fp       , Gs^Fms      , Gs^Fms      , Hh^Fp       , Hh^Fp       , Md          , Hh          , Gs^Fds      , Gs^Fms      , Gs^Fms      , Gs^Fms      , Gs^Fms      , Gs^Fms      , Gs^Eff      , Gs^Gvs      , Gs          , Gg^Efm      , Gs^Fms      , Gs^Fms      , Gs          , Gs          , Gs^Fms      , Gs^Fms      , Gg          , Gs^Fms      , Gg          , Gs^Fms      , Gs^Fms      , Gs^Fms      , Gs^Fms      , Gs^Fms      , Gs^Fms      
Gs^Fms      , Gs^Fms      , Gs^Fms      , Gs          , Gs^Fms      , Gs^Fms      , Hh^Fp       , Hh^Fp       , Mm^Xm       , Mm^Xm       , Hh          , Gs^Fms      , Gs^Fms      , Gs^Fms      , Gs^Eff      , Gs^Eff      , Gs^Gvs      , Gs^Eff      , Gs^Eff      , Gs^Fms      , Gs^Fms      , Gs^Fms      , Gs          , Gs          , Gs          , Gs^Fms      , Gs^Fms      , Gs^Fms      , Gg          , Gg          , Gg          , Gs^Fms      , Gs^Fms      , Gs^Fms      , Gs^Fms      
Gs^Fms      , Gs^Fms      , Gs^Fds      , Gs^Fms      , Gs^Fms      , Gs^Fms      , Gs^Fms      , Md          , Md          , Mm^Xm       , Hh^Fp       , Gs^Fds      , Gs^Fds      , Gs^Eff      , Gs^Eff      , Gs^Gvs      , Gs^Gvs      , Gs^Gvs      , Gs          , Gg^Ve       , Re          , Gs          , Gs^Fds      , Gs          , Gs          , Gs^Fms      , Gs^Fms      , Gs^Fms      , Gs^Fms      , Gs^Fms      , Gg          , Gg          , Gs^Efm      , Gs^Fms      , Gs^Fms      
Gs^Fms      , Gs^Fms      , Gs^Fms      , Gs^Fds      , Gs^Fds      , Gs^Fms      , Hh^Fp       , Hh^Fp       , Hh^Fp       , Md          , Hh^Wm       , Gs^Fms      , Gs^Fms      , Gs^Fds      , Gs^Fms      , Gg^Ve       , Re          , Re          , Re          , Re          , Gs^Fms      , Gs^Fms      , Gs^Fds      , Gs^Fds      , Gs^Fms      , Gs^Fds      , Gs^Fms      , Gs^Fms      , Gg          , Gg          , Gs^Fms      , Gg          , Gs^Fms      , Gs^Fms      , Gs^Fms      
Gll^Fp      , Gs          , Gd          , Gd          , Gs^Fms      , Gs^Fms      , Gs^Fms      , Hh^Fp       , Hh^Fp       , Hh^Vhh      , Gs^Fms      , Hh^Fp       , Gs^Fms      , Gs^Fms      , Gs^Fms      , Gs          , Re          , Ww          , Ww          , Ww          , Ww          , Ww          , Hh          , Gs^Fms      , Gs^Fms      , Gg          , Hh^Fms      , Hh^Fms      , Hh^Fms      , Gg          , Gs^Fms      , Gs^Fms      , Gs^Fms      , Gs^Fms      , Gs^Fms      
Gll^Fp      , Gll^Fp      , Gs^Fms      , Gs^Fms      , Gs^Fms      , Gs^Fms      , Gs^Efm      , Gs          , Gs^Fds      , Gs          , Gs^Fms      , Gs^Fms      , Gs          , Gs^Fms      , Ww          , Gs^Fms      , Ww          , Ww          , Ww          , Ww          , Gs^Fms      , Mm          , Hh^Fds      , Mm          , Hh^Fms      , Hh^Fms      , Hh^Fms      , Hh          , Gs^Fms      , Gs^Fms      , Gs^Fms      , Gg          , Hh^Fms      , Gs^Fms      , Gs^Fms      
Gs^Fms      , Gs^Fms      , Gs          , Gs^Fms      , Gg^Fet      , Gs^Fms      , Gs^Fms      , Gs^Fms      , Gs^Fms      , Gs^Fms      , Mm          , Ww          , Ww          , Ww          , Ww          , Ww          , Wo          , Ww          , Ww          , Wwr         , Hh^Fds      , Hh^Fms      , Hh^Fds      , Gs^Fms      , Gg          , Gll^Fp      , Gll^Fp      , Gs^Fms      , Gs^Fms      , Gs^Fms      , Gs^Fms      , Hh^Fms      , Hh^Fms      , Hh          , Hh          
Gs^Fms      , Gs^Fms      , Gs^Fms      , Gs^Fms      , Mm          , Mm          , Mm          , Mm          , Hh^Fp       , Mm          , Mm          , Ww          , Ww          , Gs^Fms      , Wo          , Wo          , Wo          , Wo          , Ww          , Wwr         , Gs^Fms      , Hh^Fds      , Gs^Fms      , Gll^Fp      , Gs^Fms      , Gg          , Gg          , Gg          , Gll^Fp      , Gg          , Hh^Fms      , Hh^Fms      , Gg          , Hh^Fms      , Gs^Fms      
Gs^Fms      , Re          , Gs^Fds      , Mm          , Mm          , Mm          , Mm          , Hh^Fp       , Mm^Xm       , Mm^Xm       , Mm^Xm       , Mm          , Ww          , Ww          , Ww          , Wo          , Wo          , Wo          , Ww^Vm       , Gs^Fms      , Gs^Fms      , Gs^Fms      , Gs^Fms      , Hh          , Gs^Fms      , Hh^Fms      , Gs^Fms      , Gs^Fms      , Gs^Fms      , Gs^Fms      , Gs^Fms      , Gg          , Gg          , Gg          , Gs^Fms      
Gs^Fms      , Gs^Fds      , Mm^Xm       , Mm          , Mm          , Mm          , Mm          , Md          , Mm          , Mm^Xm       , Mm          , Gs^Fms      , Gs^Efm      , Gg^Fet      , Wo          , Wo          , Ww          , Ww          , Gs^Fms      , Gs^Fms      , Gs^Fms      , Gs^Fms      , Gg          , Gg          , Gs^Fms      , Gg          , Gs^Fms      , Gs^Fms      , Gs^Fms      , Gs^Fms      , Gs^Fms      , Gg          , Gs^Fms      , Gs^Vc       , Gs^Fms      
Gs^Fms      , Gs^Fms      , Gs^Fms      , Ch          , 5 Kh        , Mm          , Gs^Fms      , Hh^Fp       , Hh^Fp       , Hh^Fp       , Hh^Fp       , Gs^Fms      , Gs^Fms      , Wo          , Gs^Fms      , Ww          , Gs^Fms      , Gs^Fms      , Gs^Fms      , Gs^Fms      , Gs^Fms      , Gs^Fms      , Gs^Fms      , Gs^Fms      , Gs^Fms      , Gs^Fms      , Gs^Fms      , Gs^Fms      , Gg          , Gs^Fms      , Gg          , Gs^Fms      , Gs^Fms      , Gs^Fms      , Gs^Fms      
Gs^Fms      , Gg^Ve       , Gs^Fds      , Ch          , Ch          , Ch          , Rb          , Hh^Vhh      , Hh          , Hh^Fp       , Hh^Fp       , Hh^Fp       , Ww          , Wo          , Gs^Fms      , Gs^Fms      , Hh^Vhh      , Gs^Fms      , Gs^Fms      , Gs^Fms      , Gs^Fms      , Gs^Fms      , Gg          , Gs^Fms      , Gs^Fms      , Gg          , Gg          , Gg          , Gs^Fms      , Gg          , Gs^Fms      , Gs^Fms      , Gg          , Gs^Fms      , Gs^Fms      
Gs^Fms      , Gs^Fms      , Gs^Fms      , Gs^Fms      , Gs^Fds      , Gs^Fms      , Hh          , Rb          , Gs          , Hh^Fp       , Hh^Fp       , Gs^Fms      , Wo          , Wo          , Md          , Gs^Fms      , Hh^Fp       , Hh^Fds      , Hh^Fds      , Gs^Fms      , Gs^Fms      , Gs^Fms      , Gs^Fms      , Gs^Fms      , Gs^Fms      , Gs^Fms      , Gs^Fms      , Gs^Fms      , Gs^Fms      , Gs^Fms      , Gs^Fms      , Gs^Fms      , Gs^Fms      , Gg          , Gs^Fms      
Gs^Fms      , Gs^Fms      , Gs^Fms      , Gs^Fds      , Gs^Fms      , Gs^Fds      , Gs^Fms      , Gd          , Gs^Fms      , Hh^Fp       , Gs^Fms      , Ww          , Wo          , Md          , Md          , Hh^Fp       , Md          , Hh^Fp       , Hh          , Gs^Fms      , Hh^Fds      , Gs^Fms      , Gs^Vc       , Gs^Fms      , Gs^Fms      , Gs^Fms      , Gs^Fms      , Gs^Fms      , Gg          , Gs^Fms      , Gg          , Gs^Fms      , Gs^Fms      , Gs^Fms      , Gs^Fms      
Gs^Fms      , Gs^Fms      , Ss          , Ss          , Gs^Fms      , Ss          , Gs^Fms      , Gs          , Gd          , Gd          , Ww^Bw\      , Ww          , Wo          , Wo          , Gs^Fms      , Md          , Md          , Md          , Hh^Fp       , Hh^Fp       , Hh^Fp       , Hh          , Gs^Fms      , Gs^Fms      , Gs^Fms      , Gs^Fms      , Gg          , Gg          , Ce          , Gg          , Gll         , Gs^Vh       , Gs^Fms      , Gs^Fms      , Gs^Fms      
Gs^Fms      , Gs^Fms      , Ss          , Wwg         , Wwf         , Gs^Fms      , Gs^Fms      , Gs^Fms      , Gs^Fms      , Gs^Fms      , Ww          , Ww^Bw\      , Gs^Fms      , Ww          , Ww^Vm       , Gs^Fms      , Md          , Md          , Gs^Fms      , Hh^Fds      , Hh          , Hh          , Gs^Fms      , Gs^Fms      , Gg          , Gg          , Gg          , Ce          , 1 Ket       , Ce          , Rb          , Gg          , Gg          , Gs^Fms      , Gs^Fms      
Ss          , Ss          , Wwf         , Ss^Vhs      , Ww          , Gs^Fms      , Ww          , Gs^Fms      , Ww          , Ww          , Ww          , Wo          , Wo          , Ww^Bw\      , Ww^Bw\      , Gs^Fms      , Md          , Gs^Fms      , Gs^Fms      , Gs^Fms      , Gs^Fms      , Gs^Fms      , Gs^Fms      , Gs^Fms      , Gs^Gvs      , Gg^Gvs      , Gg          , Ce          , Ce          , Rb          , Gg          , Rb          , Rb          , Gs^Fms      , Gs^Fms      
Gs^Fms      , Ss          , Ww          , Ww          , Ww          , Ww          , Wwg         , Ww          , Wwr         , Wo          , Wo          , Wo          , Wo          , Wo          , Ww          , Rb          , Re          , Gs          , Gs          , Gd          , Gd          , Rb          , Rb          , Gll         , Gs^Vh       , Gs^Gvs      , Gs^Fms      , Gg          , Gs^Fms      , Gg          , Gs^Fms      , Gs^Fms      , Rb          , Gs^Fms      , Gs^Fms      
Gs^Fms      , Ww          , Ww          , Wwrg        , Ss          , Wwg         , Wwf         , Ss          , Ss          , Ss          , Ss          , Wo          , Wo          , Wo          , Ww          , Ww          , Hh          , Hh          , Gs^Fms      , Gs^Fms      , Gs^Fms      , Gs^Fms      , Gs^Fms      , Gs^Fms      , Gs^Gvs      , Gs^Gvs      , Gs^Gvs      , Gs^Fms      , Gs^Fms      , Gs^Fms      , Gs^Fms      , Gs^Fms      , Rb          , Rb          , Gs^Fms      
