border_size=1
usage=map

Wwf         , Wwf         , Wwf         , Ss          , Ss          , Ss          , Ss^Es       , Ss^Es       , Rb^Es       , Rp          , Sm          , Ss          , Ss          , Wwg         , Wwg         , Ss          , Ss^Em       , Ss          , Ss          , Ss          , Ss          , Ss          , Ss          , Wwf         , Wwf         , Wwf         , Ss          , Ss          , Ss          , Ss^Emf      , Ss^Em       , Ss^Em       , Rb          , Ss^Em       , Ss          , Ss          , Gll         , Ss          , Wwg^Em      , Wwg         , Wwf         , Wwf         , Sm^Em       , Sm          , Sm^Es       
Wwf         , Wwf         , Ss          , Ss          , Ss          , Ss          , Ss          , Ss^Es       , Ss          , Rp          , Sm          , Sm          , Ss^Em       , Ss^Vhs      , Wwg^Bw\r    , Wwg         , Wwg         , Wwg         , Wwg         , Ss          , Ss          , Ss          , Wwf         , Ss          , Ss          , Ss          , Ss          , Ss          , Ss          , Ss^Em       , Ss^Em       , Rb^Em       , Ss^Emf      , Ss^Em       , Ss          , Re          , Gd^Es       , Wwf^Em      , Wwf^Em      , Wwf         , Ss          , Wwg         , Ss^Vhs      , Sm          , Sm          
Wwrg        , Ss          , Wwf         , Ss          , Ss          , Ss          , Ss          , Ss          , Ss          , Rp          , Wwg         , Wwg         , Wwg^Em      , Ss^Emf      , Wwg^Bw/r    , Rb          , Rb          , Ss^Em       , Rb          , Ss          , Ss          , Ss          , Ss          , Ss          , Wwf         , Wwf         , Ss          , Ss          , Ss          , Ss          , Rb          , Re          , Uu^Uf       , Ss^Em       , Ss          , Rb^Es       , Gll         , Gd^Vhr      , Wwf         , Wwf         , Ss          , Ss          , Ss          , Sm          , Sm          
Wwrg        , Wwrg        , Wwf         , Wwf         , Wwf         , Wwf         , Wwf         , Ss          , Rp          , Rp          , Ss          , Wwg         , Ss          , Ss^Vhs      , Ss          , Ss          , Ss          , Rb          , Rb          , Rb          , Ss          , Ss          , Ss          , Ss          , Ss          , Wwf         , Ss          , Ss          , Ss          , Rb          , Ss          , Ss          , Wwf         , Ss          , Wwf         , Wwf         , Rb          , Rb          , Rb          , Ss          , Chs         , Chs         , 4 Khs       , Wwf         , Wwf         
Ss          , Wwf         , Ss          , Ss          , Ss          , Ss          , Sm          , Sm          , Rp          , Wwf         , Wwf         , Wwf         , Wwg         , Ss          , Wwf         , Wwf         , Wwf         , Wwf         , Ss^Em       , Rb^Es       , Rb^Es       , Ss          , Rb          , Ss          , Ss          , Ss          , Rb          , Ss          , Rb          , Rb          , Rb          , Ss          , Ss          , Wwf         , Wwf         , Gll         , Hhd^Fdw     , Hhd^Fdw     , Gd^Fetd     , Re          , Ss          , Wwrg        , Chs         , Chs         , Wwf         
Ss          , Ss          , Ss          , Ss          , Wwg         , Ss          , Rb          , Rb          , Rp          , Wwf         , Rp          , Rp          , Rp^Es       , Ss          , Ss          , Ss          , Ss          , Wwf         , Rb          , Rb^Es       , Ss          , Rb          , Ss          , Rb^Esd      , Rb          , Rb          , Ss          , Rb          , Ss^Em       , Rb          , Rb          , Ss          , Ss          , Ss          , Ss          , Ss          , Wwf         , Wwrg        , Wwf         , Ss          , Ss          , Ss          , Rb          , Gll         , Rb          
Ss          , Ss          , Ss          , Wwg         , Wwg         , Wwg         , Rb          , Sm          , Gs^Fdw      , Rp          , Gs^Fdw      , Gd^Fetd     , Rp          , Sm^Es       , Sm          , Ss          , Ss          , Ss          , Ss          , Ss          , Ss          , Ss          , Sm          , Ss          , Ss          , Ss          , Ss^Em       , Ss^Emf      , Ss^Em       , Ss          , Ss          , Re          , Re          , Ss          , Ss          , Ss          , Ss          , Ss          , Ss          , Ss          , Ss          , Ss          , Ss^Vhs      , Wwf         , Wwg         
Ss          , Ss          , Ss          , Sm          , Sm          , Rb          , Gs^Fdw      , Sm          , Gs^Fdw      , Gll         , Wwf         , Gs^Fdw      , Wwf         , Wwf^Bw\r    , Wwf^Bw\r    , Wwf         , Wwf         , Wwf         , Ss          , Ss          , Ss          , Ss          , Sm          , Sm          , Ss          , Ss          , Sm^Es       , Sm^Em       , Sm^Es       , Ss^Em       , Ss          , Ss          , Rb          , Ss          , Ss          , Ss          , Wwf         , Ss          , Ss          , Wwf         , Wwf         , Wwf         , Ss          , Ss          , Wwg         
Ss          , Ss          , Ss          , Sm          , Ss^Vhs      , Rb          , Wwg         , Gs^Fdw      , Gs^Fdw      , Wog         , Wog         , Wwrg        , Wwf         , Wwf         , Wwrg        , Rp          , Sm^Em       , Chw         , Chs         , Ss          , Wwf         , Ss          , Wwf         , Wwf         , Wwf         , Sm          , Sm          , Sm^Es       , Sm          , Ss          , Wwf         , Ss          , Rb^Es       , Rb          , Ss          , Ss          , Wwg         , Wwg         , Wwg         , Wwg         , Ss          , Wwf         , Ss          , Wwf         , Wwg         
Wwg         , Wwg         , Wwg         , Wwg         , Chs         , Wwg^Bw|r    , Wwg         , Wog         , Wog         , Wog         , Sm          , Sm          , Sm          , Sm          , Rb          , Rp          , Chr         , 1 Khw       , Chr         , Wwf         , Wwf         , Wwf         , Ss          , Wwf         , Ss          , Wwf         , Wwf         , Wwf^Es      , Ss          , Ss          , Ss          , Ss          , Rb          , Sm          , Wwg         , Wwg         , Wwg         , Wwg         , Wwg         , Wwg         , Ss          , Ss          , Ss          , Wwg         , Wwg         
Wwg         , Ss          , Wwg         , Wwg         , 5 Khw       , Chw         , Wwg         , Wwg         , Wwrg        , Ss          , Ss          , Gll         , Gll         , Gd^Vhr      , Gd          , Rb          , Rb          , Rb          , Rp          , Rb          , Ss^Vhs      , Wwf         , Wwg         , Ss          , Wwg         , Ss          , Ss          , Ss          , Ss          , Ss          , Ss          , Ss          , Rb          , Wwf         , Wwf         , Wwf         , Sm          , Ss          , Sm          , Ss          , Wwrg        , Ss          , Ss          , Ss          , Ss          
Ss          , Wwg         , Wwg^Bw/r    , Wwg^Bw/r    , Wwg         , Wwg         , Wwg         , Wwrg        , Wwf         , Wwf         , Gll         , Gs^Fdw      , Gll         , Gd          , Gll^Es      , Gd          , Gs^Fdw      , Re^Vct      , Gs^Fdw      , Rp          , Ss          , Wwg         , Wwg         , Wwg         , Wwg         , Wwg         , Ss          , Ss          , Ss          , Ss          , Ss          , Ss          , Ss          , Rb          , Sm          , Wwf         , Sm^Es       , Sm^Es       , Ss          , Sm^Em       , Sm^Emf      , Wwf         , Ss          , Ss          , Ss          
Ss          , Sm          , Wwg         , Wwg         , Wwg         , Wog         , Wog         , Wwg         , Wwg         , Ss          , Ss          , Gll         , Gs^Fdw      , Hhd^Fdw     , Hhd^Fdw     , Gd^Fmw      , Hhd^Fdw     , Gs^Fdw      , Rb          , Rp          , Ss          , Ss          , Wwg         , Wwg         , Wwg         , Ss          , Ss          , Ss          , Ss          , Ss          , Ss          , Ss          , Ss          , Rb          , Rb          , Sm          , Rb          , Ss          , Ss          , Ss^Em       , Ss^Em       , Ss          , Ss          , Ss          , Ss          
Ss          , Sm          , Gs^Fdw      , Gd^Fetd     , Gs^Fdw      , Wwg         , Wog         , Wog         , Wog         , Wwg         , Wwg         , Ss          , Rb          , Hhd^Fdw     , Rb^Es       , Hhd         , Hhd^Fdw     , Rb          , Rb          , Rp          , Rp          , Wwg         , Rp          , Wwg         , Rp          , Ss          , Rp          , Ss          , Ss          , Ss          , Ss          , Ss          , Ss          , Ss          , Ss          , Ss          , Ss          , Ss          , Ss          , Ss          , Ss          , Ss          , Ss          , Wwf         , Sm          
Gs^Fdw      , Rb          , Rb          , Gs^Fdw      , Wwg         , Wwg         , Wog         , Wog         , Wog         , Wog         , Wwg         , Ss          , Rb          , Rb^Es       , Rb          , Rb^Es       , Wwg         , Rb          , Wwg         , Rb          , Rb          , Rp          , Uu^Uf       , Rp          , Ss          , Rp          , Rp          , Rp          , Rp          , Wwg         , Wwg         , Wwg         , Wwg         , Ss          , Wwg         , Wwg         , Wwg         , Wwg         , Ss          , Ss          , Ss          , Ss          , Wwg         , Wwf         , Wwf         
Gs^Fdw      , Gs^Fdw      , Rb          , Gs^Fdw      , Hhd^Fdw     , Wwg         , Wog         , Wog         , Wog         , Wog         , Wog         , Wwg         , Wwg^Bw/r    , Rb          , Wwf         , Wwg         , Wog         , Wwg         , Wwg         , Ss          , Wwg         , Ss          , Wwg^Emf     , Ss          , Wwg^Bw/r    , Ss^Bw/r     , Ss          , Ss          , Rp          , Ss          , Wog         , Wog         , Wwg         , Wwg         , Wwf         , Wwg         , Wwf         , Wwf         , Wwf         , Wwf         , Ss          , Wwg         , Ss          , Wwg         , Wwg         
Gs^Fdw      , Rb          , Rb          , Hhd^Fdw     , Hhd         , Rb          , Rb^Es       , Wog         , Wwg         , Wog         , Wog^Bw/r    , Wwg^Bw/r    , Wwg         , Wwf         , Wwf         , Wwf         , Wwf         , Wog         , Wog         , Wog         , Wog         , Wwg^Em      , Sm          , Wog^Bw/r    , Wog         , Wwg         , Wwg         , Wwg         , Wog         , Wog^Bw\r    , Wog^Bw\r    , Wog         , Wwg         , Wwf         , Wwf         , Wwrg        , Wwrg        , Wwrg        , Wwf         , Wwrg        , Ss          , Ss          , Ss          , Ss          , Wwg         
Gd^Fmw      , Gd^Fmw      , Rb          , Hhd^Fdw     , Rb^Es       , Rb^Es       , Rb          , Wwg         , Wwg^Bw/r    , Wwg^Bw/r    , Wwg         , Wwg         , Ss^Emf      , Wwg         , Wwf         , Wwf         , Wwf         , Wwg         , Wwg         , Wwg         , Wog         , Wog         , Wog^Bw|r    , Wog         , Wog         , Wog         , Wog         , Wog         , Wog         , Wog         , Wwg         , Rp          , Rp          , Wwg^Bw|r    , Rp          , Ss^Vhs      , Ss          , Wwf         , Ss          , Ss          , Ss          , Ss          , Wwg         , Wwg         , Ss          
Gd^Fmw      , Gs^Fdw      , Rb          , Gs^Fdw      , Rb          , Rb          , Rb          , Rb          , Gs^Fdw      , Wwg         , Wwg         , Wwg         , Wwg         , Wwg         , Ss          , Wwf         , Ss          , Ss          , Ss          , Ss          , Wwg         , Wog         , Wog^Bw|r    , Wog         , Wwg         , Wwg         , Wwg         , Wwg         , Wwg         , Wwg         , Ss^Vhs      , Ss          , Ss          , Rp          , Rb          , Rp          , Ss          , Ss          , Ss          , Ss          , Hhd         , Ss          , Wwg         , Wwg         , Wwg         
Gd^Fmw      , Rb          , Gd^Fmw      , Rb          , Rb          , Rb          , Gs^Fdw      , Rb          , Rb          , Gs^Fdw      , Rb          , Wwf         , Wwf         , Ss          , Ss          , Wwg         , Wwg         , Ss          , Ss          , Ss          , Ss          , Wwg         , Rp          , Wwg         , Wwf         , Wwf         , Ss          , Wwf         , Wwf         , Wwf         , Ss          , Ss          , Rb          , Rp          , Rb          , Ss          , Gll         , Gll         , Gd^Vhr      , Ss          , Hhd^Es      , Ss          , Ss          , Wwg^Es      , Hhd^Fdw     
Ss          , Gd^Fmw      , Rb          , Gs^Vc       , Rb          , Gs^Fdw      , Gs^Fdw      , Rb          , Rb          , Gs^Fdw      , Wwf         , Wwf         , Ss          , Ss          , Rb          , Wwg         , Wwf         , Ss          , Wwf         , Wwf         , Ss          , Ss          , Rp          , Ss          , Ss          , Ss          , Ss          , Wwf         , Wwf         , Ss          , Chw         , Chw         , Chs         , Rp          , Sm          , Rb          , Hhd^Fdw     , Gd          , Gll         , Gll         , Hhd^Fdw     , Hhd^Fmw     , Ss          , Ss          , Hhd^Fdw     
Hhd^Fmw     , Hhd^Fmw     , Rb          , Gs^Fdw      , Rb          , Rb          , Ce          , Gs^Fdw      , Gs^Fdw      , Wwf         , Wwf         , Gs^Fdw      , Gs^Fdw      , Rb          , Ss          , Rb          , Sm          , Rb          , Wwf         , Wwf         , Rb          , Sm          , Sm          , Rp          , Rp          , Ss          , Ss          , Ss          , Sm          , Sm          , Rp          , 3 Khs       , Chs         , Sm          , Sm^Es       , Rb          , Hhd^Fdw     , Hhd^Fdw     , Hhd         , Hhd^Es      , Hhd         , Hhd^Fmw     , Hhd^Fmw     , Hhd^Fdw     , Hhd^Fmw     
Hhd^Fmw     , Rb          , Gs^Fdw      , Rb          , Ce          , Rb          , 2 Ke        , Gd^Vhr      , Gs^Fdw      , Ss^Em       , Gs^Fdw      , Gs^Fdw      , Ss          , Rb          , Ss          , Ss          , Ss          , Wwf         , Wwf         , Wwf         , Ss          , Ss          , Wwg         , Rp          , Ss          , Rp          , Rp          , Rp          , Rp          , Rp          , Rb          , Rp          , Hhd^Vhhr    , Rp          , Rp          , Wwg         , Wwg         , Wwg         , Wwg         , Hhd         , Wwg         , Ss          , Ss          , Ss          , Ss          
Rb          , Hhd^Fmw     , Gs^Fdw      , Rb          , Rb          , Ce          , Ce          , Rb          , Gs^Fdw      , Gs^Fdw      , Gs^Fdw      , Ss          , Wwg         , Wwg         , Wwg         , Wwg         , Wwg         , Wwg         , Wwg         , Wwg         , Ss          , Ss          , Wwg         , Wwg         , Wwg         , Wwg         , Wwg         , Wwg         , Wwg         , Wwg         , Wwrg        , Hhd^Fdw     , Gs^Fdw      , Rb          , Hhd^Fmw     , Rp          , Rp          , Wwg         , Wwrg        , Wwg         , Wwg         , Ss          , Ss          , Ss          , Ss          
Hhd^Fdw     , Gd^Vhr      , Rb          , Rb          , Gd^Fmw      , Rb          , Gd^Fmw      , Rb^Es       , Gs^Fdw      , Gs^Fdw      , Gs^Fdw      , Ss          , Wwg         , Wwg         , Wwg         , Wwg         , Wwg         , Wwg         , Wwg         , Ss          , Ss          , Wwg         , Wwg         , Ss          , Wwg         , Wwg         , Ss          , Wwg         , Ss          , Wwg         , Ss          , Hhd^Fdw     , Hhd^Fdw     , Hhd^Fmw     , Re          , Re          , Rp          , Wwrg        , Wwf         , Wwrg        , Sm          , Ss          , Ss^Es       , Ss          , Ss          
Hhd^Fdw     , Hhd^Fdw     , Rb          , Rb          , Rb          , Gd^Fmw      , Gd^Fmw      , Gs^Fdw      , Ss          , Ss^Em       , Ss          , Ss          , Ss          , Ss          , Ss          , Wwg         , Ss^Vhs      , Wwg         , Ss          , Wwg         , Ss          , Wwg         , Ss          , Wwg         , Ss          , Wwg         , Ss          , Ss          , Ss          , Ss          , Ss          , Wwrg        , Gs^Fdw      , Gs^Fdw      , Rb          , Wwf         , Wwf         , Rp          , Rp          , Rp          , Rp          , Rp^Es       , Rp^Es       , Ss          , Ss          
Rb          , Rb          , Rb          , Gd^Fmw      , Gd^Fmw      , Gd^Fmw      , Gd^Fetd     , Gs^Fdw      , Gs^Fdw      , Ss          , Ss          , Ss          , Ss          , Ss          , Ss          , Ss          , Ss          , Ss          , Wwf         , Wwf         , Wwf         , Ss          , Ss          , Ss          , Ss          , Ss          , Ss          , Ss          , Ss          , Wwg         , Wwg         , Wwg         , Wwg         , Gs^Fdw      , Rb          , Sm          , Sm          , Ss          , Sm          , Ss          , Ss          , Rp          , Rp          , Ss          , Ss          
Gd^Fmw      , Rb          , Gd^Fmw      , Gd^Fmw      , Hhd         , Gs^Fdw      , Gs^Fdw      , Gs^Fdw      , Gs^Fdw      , Gs^Fdw      , Gs^Fdw      , Ss          , Ss          , Ss          , Ss          , Ss          , Ss          , Ss          , Ss          , Wwf         , Wwf         , Wwf         , Ss          , Ss          , Ss          , Ss          , Ss          , Ss          , Ss          , Wwg         , Ss          , Wwg         , Ss          , Wwg         , Wwg         , Rb          , Ss          , Ss          , Ss          , Ss          , Ss          , Ss          , Ss          , Rp          , Ss          
Rb          , Rb          , Gs^Fdw      , Gs^Fdw      , Hhd^Fdw     , Hhd^Fdw     , Hhd^Fdw     , Hhd^Fdw     , Gs^Fdw      , Gs^Es       , Gs^Fdw      , Ss          , Ss          , Ss          , Ss          , Wwf         , Wwf         , Wwf         , Wwf         , Wwf         , Ss          , Wwf         , Wwf         , Ss          , Ss          , Ss          , Ss          , Ss          , Ss          , Ss          , Ss          , Ss          , Ss          , Wwg         , Rb          , Rb          , Ss          , Ss          , Ss          , Ss          , Ss          , Ss          , Ss          , Rp          , Rp          
