border_size=1
usage=map

Xu          , Xu          , Xu          , Xu          , Xu          , Xu          , Xu          , Xu          , Xu          , Xu          , Xu          , Xu          , Xu          , Xu          , Xu          , Xu          , Uu^Uf       , Uu          , Xu          , Xu          , Xu          , Xu          , Xu          , Xu          , Xu          , Xu          
Xu          , Uu^Vud      , Uu^Uf       , Uh          , Uu^Uf       , Qxu         , Ur          , Uu          , Uu          , Uu^Uf       , Uu^Ii       , Uu^Uf       , Uh          , Xu          , Uh          , Uh          , Ur          , Uu^Uf       , Uu          , Uh          , Uu^Dr       , Uu^Vud      , Ur          , Cud         , 3 Ko        , Xu          
Xu          , Uu^Vu       , Uu          , Ur          , Ur          , Ur          , Ur          , Ur          , Uu          , Ur          , Ur          , Ur          , Xu          , Xu          , Ur          , Uu^Ii       , Ur          , Ur          , Ur          , Uu          , Ur          , Ur          , Ur^Ii       , Cud         , Cud         , Xu          
Xu          , Cud         , Cud         , Ur^Ii       , Uu          , Uu          , Xu          , Xu          , Xu          , Uh          , Uu          , Ur          , Xu          , Xu          , Ur          , Uu          , Uh          , Xu          , Xu          , Qxu         , Uu^Uf       , Ur          , Uu^Vud      , Uu          , Uu^Vu       , Xu          
Xu          , 1 Kud       , Xu          , Cud         , Uu^Uf       , Uu^Vud      , Xu          , Xu          , Ww          , Cud         , Ur          , Uu          , Uh          , Uu^Uf       , Ur          , Cud         , Xu          , Xu          , Xu          , Xu          , Xu          , Xu          , Xu          , Uu^Uf       , Xu          , Xu          
Xu          , Xu          , Qlf         , Xu          , Xu          , Xu          , Xu          , Wwf         , Ww          , Ds          , Uu^Dr       , Ur          , Uu          , Ur          , Uu          , Qxu         , Qxu^Bs/     , Uu^Vud      , Xu          , Cud         , Uu          , Uu^Uf       , Uu^Uf       , Xu          , Xu          , Xu          
Xu          , Xu          , Xu          , Xu          , Xu          , Uu^Uf       , Uu^Vu       , Xu          , Ww^Vm       , Wo          , Uh          , Uh          , Ur          , Uu          , Uu          , Ur          , Ur          , Qxu         , Ur          , Ur          , Uu          , Uu          , Uu          , Uh          , Xu          , Xu          
Uh          , 2 Kud       , Cud         , Cud         , Uu^Dr       , Ur          , Uh          , Xu          , Xu          , Xu          , Uh          , Xu          , Xu          , Cud         , Ur          , Uu          , Uu          , Ur          , Uu^Ii       , Uu          , Xu          , Uu          , Ur          , Uu          , Uu^Uf       , Xu          
Xu          , Cud         , Ur^Ii       , Uu          , Uu^Uf       , Uu^Uf       , Uu^Vu       , Xu          , Xu          , Uu^Uf       , Uu          , Uh          , Uu          , Uu          , Ur          , Uu          , Uh          , Uu^Dr       , Uu^Uf       , Uu^Uf       , Xu          , Xu          , Ur          , Uu          , Uh          , Xu          
Xu          , Uu^Vud      , Ur          , Uu          , Ur          , Xu          , Xu          , Xu          , Xu          , Uu          , Ur          , Uu          , Uu          , Ur          , Ql^Bs\      , Ql          , Ql          , Ql          , Xu          , Xu          , Uu^Uf       , Uh          , Ur          , Ur          , Ur          , Xu          
Xu          , Qxu         , Ur          , Ur          , Xu          , Xu          , Cud         , Uu^Uf       , Uu^Ufi      , Uu^Uf       , Ur          , Ur          , Cud         , Ql          , Uu^Ufi      , Uu          , Uh^Ii       , Uh          , Xu          , Xu          , Uu^Dr       , Ur          , Uu          , Qxu         , Uu^Vu       , Xu          
Xu          , Uu^Uf       , Uu^Ufi      , Uu          , Ur          , Uu          , Ur          , Uu          , Ur          , Ur          , Uh          , Uu^Uf       , Ql          , Ql          , Uu^Vu       , Uu^Vud      , Xu          , Uu^Uf       , Xu          , Uu^Vud      , Uu          , Ur          , Ur^Ii       , Ur          , Co          , Xu          
Xu          , Xu          , Uu^Dr       , Ur          , Uh          , Uu          , Uu          , Ur          , Ur          , Xu          , Uh          , Xu          , Ql          , Ql          , Uh          , Qlf         , Xu          , Xu          , Uh          , Uu^Uf       , Uu^Vud      , Uu          , Co          , Co          , 4 Kud       , Xu          
Xu          , Xu          , Xu          , Xu          , Xu          , Xu          , Xu          , Xu          , Xu          , Xu          , Xu          , Xu          , Xu          , Xu          , Xu          , Xu          , Xu          , Xu          , Xu          , Xu          , Xu          , Xu          , Xu          , Xu          , Xu          , Xu          
