border_size=1
usage=map

Re          , Re          , Re          , Co          , Re          , Ds          , Ds          , Ds          , Ds          , Ds          , Ds          , Md^Xm       , Md^Xm       , Md^Xm       , Md          , Ds          , Ds          , Ds          , Ds          , Ds          , Ds          , Ds          , Ds          , Ce          , Rd          , Rd          
Co          , 2 Ko        , Co          , Co          , Ds          , Ds          , Ds          , Ds          , Ds          , Ds          , Hd          , Md          , Md^Xm       , Md^Xm       , Hd          , Ds          , Ds          , Ds          , Re          , Dd^Vdt      , Rd          , Rd          , Dd^Vda      , Ce          , 3 Ke        , Rd          
Co          , Co          , Uu^Vud      , Ds          , Ds          , Dd^Vdt      , Dd          , Dd          , Ds          , Ds          , Dd^Do       , Md          , Dd^Dc       , Hd          , Hd          , Hd          , Ds          , Ds          , Dd          , Re          , Ds          , Rd          , Dd^Do       , Ce          , Ce          , Ce          
Ds          , Ds^Dr       , Rd          , Rd          , Re          , Rd          , Re          , Dd^Do       , Ds          , Ds          , Hd          , Re          , Hh          , Md^Xm       , Md          , Re          , Ds          , Ds          , Ds          , Dd          , Ds          , Ds          , Ds          , Re          , Dd^Vda      , Rd          
Hd          , Uu^Vud      , Hd          , Ds          , Dd          , Rd          , Dd          , Ds          , Ds          , Ds          , Ds          , Ds          , Hh^Fms      , Md^Xm       , Hh          , Hd          , Rd          , Ds          , Ds          , Dd          , Ds          , Dd          , Dd          , Dd^Dc       , Re          , Ds          
Md^Xm       , Dd^Do       , Md^Xm       , Ds          , Ds          , Ds          , Md          , Md          , Md^Xm       , Ds          , Ds          , Re          , Gs          , Hh^Fds      , Dd^Vdt      , Hd          , Gs^Ft       , Dd          , Ds          , Ds          , Ds^Dr       , Ds          , Ds          , Dd^Do       , Ds          , Ds          
Md          , Md^Xm       , Hd          , Md^Xm       , Dd          , Md          , Md          , Md^Xm       , Md^Xm       , Dd^Do       , Dd          , Dd^Do       , Ww          , Gg^Fet      , Ww          , Ww          , Gs          , Dd^Do       , Rd          , Ds          , Hd          , Ds          , Hd          , Rd          , Md^Xm       , Hd          
Ds          , Hd          , Re          , Hd          , Ds          , Re          , Ds          , Rd          , Ds          , Ds          , Rd          , Gs^Ft       , Dd^Vda      , Ww          , Wwr         , Ww          , Rd          , Ds          , Md^Xm       , Md          , Md          , Hd          , Md^Xm       , Md^Xm       , Md^Xm       , Md          
Ds          , Rd          , Ds^Dr       , Rd          , Ds          , Ds          , Dd          , Ds          , Ds          , Rd          , Ds          , Gs          , Gs^Ft       , Gs^Ft       , Hh          , Gs^Ft       , Rd          , Hd          , Md^Xm       , Md          , Md          , Dd          , Hd          , Md          , Hd          , Md^Xm       
Qxu^Bs/     , Uu^Vu       , Rd          , Ds          , Dd^Dc       , Ds          , Rd          , Ds          , Dd^Do       , Dd^Dc       , Hd          , Hh          , Md          , Md^Xm       , Hd          , Dd          , Ds          , Rd          , Ds          , Re          , Ds          , Ds          , Rd          , Re          , Mm^Vhh      , Mm          
Ur          , Rd          , Ds^Dr       , Rd          , Dd^Vdt      , Rd          , Rd          , Ds          , Dd          , Dd          , Hd          , Md          , Dd          , Md^Xm       , Hd          , Rd          , Ds          , Dd          , Ds          , Ds          , Rd          , Ds          , Ds          , Rp^Vhc      , Rp          , Mm^Xm       
Ur          , Cud         , Cud         , Re          , Ds          , Ds          , Dd          , Dd          , Ds          , Re          , Dd^Dc       , Rd          , Md          , Hd          , Md          , Dd^Do       , Hd          , Dd^Dc       , Dd          , Rd          , Rp          , Rp          , Rr          , Rd          , Ch          , Rp          
Xu          , 1 Kud       , Cud         , Uu^Vud      , Ds          , Ds          , Ds          , Dd          , Re          , Dd          , Hd          , Hd          , Md^Xm       , Md^Xm       , Md          , Hd          , Hd          , Ds          , Ds          , Ds          , Rd          , Rr^Vd       , Chr         , Ch          , 4 Kh        , Ch          
Xu          , Xu          , Ur          , Ur          , Ds          , Ds          , Ds          , Dd^Do       , Ds          , Md          , Ds          , Md^Xm       , Md^Xm       , Md^Xm       , Ds          , Ds          , Ds          , Ds          , Ds          , Ds          , Ds          , Rd          , Ch          , Rp          , Rp          , Ch          
