border_size=1
usage=map

Gg          , Gg          , Gg          , Gg          , Gg          , Gg          , Gg          , Gg          , Gg          , Gg          , Gg          , Gg          , Gg          , Gg          , Gg          , Gg          , Gg          , Gg          , Gg          , Gg          , Gg          , Gg          , Gg          , Gg          , Gg          , Gg          , Gg          , Gg          , Gg          , Gg          , Rr          , Gg          , Rr          , Rr          , Gg          , Gg          , Gg          , Gg          , Gg          , Gg          , Gg          , Gg          , Gg          , Gg          , Gg          , Gg          
Gg          , Gg          , Gg          , Gg          , Gg          , Gg          , Gg          , Gg          , Gg          , Gg          , Gg          , Gg          , Gg          , Gg          , Gg          , Gg          , Gg          , Gg          , Gg          , Gg          , Gg          , Gg          , Gg          , Gg          , Gg          , Gg          , Gg          , Gg          , Rr          , Rr          , Gg          , Rr          , Gg          , Gg          , Gg          , Gg          , Gg          , Gg          , Gg          , Gg          , Gg          , Gg          , Gg          , Gg          , Gg          , Gg          
Gg          , Gg          , Gg          , Gg          , Gg          , Gg          , Rr          , Gg          , Rr          , Gg          , Rr          , Rr          , Rr          , Gg          , Rr          , Gg          , Rr          , Gg          , Rr          , Gg          , Gg          , Gg          , Gg          , Gg          , Gg          , Gg          , Rr          , Rr          , Gg          , Gg          , Gg          , Gg          , Gg          , Gg          , Gg          , Gg          , Gg          , Gg          , Gg          , Gg          , Gg          , Gg          , Gg          , Gg          , Gg          , Gg          
Gg          , Gg          , Gg          , Gg          , Rr          , Rr          , Gg          , Rr          , Gg          , Rr          , Gg          , Rr          , Gg          , Rr          , Gg          , Rr          , Gg          , Rr          , Rr          , Gg          , Gg          , Gg          , Gg          , Gg          , Rr          , Rr          , Gg          , Rr          , Gg          , Gg          , Gg          , Gg          , Gg          , Gg          , Gg          , Gg          , Gg          , Gg          , Gg          , Gg          , Gg          , Gg          , Gg          , Gg          , Gg          , Gg          
Gg          , Rr          , Rr          , Rr          , Gg          , Gg          , Gg          , Gg          , Gg          , Gg          , Gg          , Gg          , Gg          , Gg          , Gg          , Gg          , Gg          , Gg          , Gg          , Rr          , Rr          , Rr          , Rr          , Rr          , Gg          , Gg          , Gg          , Gg          , Gg          , Gg          , Gg          , Gg          , Gg          , Gg          , Gg          , Gg          , Gg          , Gg          , Gg          , Gg          , Gg          , Gg          , Gg          , Gg          , Gg          , Gg          
Rr          , Rr          , Gg          , Gg          , Gg          , Gg          , Gg          , Gg          , Gg          , Gg          , Gg          , Gg          , Ww          , Ww          , Ww          , Ww          , Ww          , Ww          , Ww          , Ww          , Ww          , Ww^Bsb|     , Ww^Bsb|     , Ww^Bsb|     , Ww          , Ww          , Ww          , Gg          , Ww          , Gg          , Ww          , Gg          , Ww          , Gg          , Gg          , Gg          , Gg          , Gg          , Gg          , Gg          , Gg          , Gg          , Gg          , Gg          , Gg          , Gg          
Gg          , Gg          , Gg          , Gg          , Gg          , Gg          , Gg          , Gg          , Gg          , Gg          , Ww          , Ww          , Gll         , Gll         , Gll         , Gll         , Gll         , Gll         , Gll         , Gll         , Gll         , Rr          , Rr          , Rr          , Gll         , Gll         , Gll         , Ww          , Gll         , Ww          , Ww          , Ww          , Ww          , Ww          , Ww          , Gg          , Gg          , Gg          , Gg          , Gg          , Gg          , Gg          , Gg          , Gg          , Ww          , Gg          
Gg          , Gg          , Gg          , Gg          , Gg          , Gg          , Ww          , Ww          , Ww          , Ww          , Gll         , Gll         , Gll         , Gll         , Ch          , Ch          , Ch          , Ch          , Ch          , Ch          , Ch          , Rr          , Ch          , Rr          , Ch          , Gll         , Ch          , Gll         , Gll         , Gll         , Gll         , Gll         , Gll         , Ww          , Gll         , Ww          , Ww          , Ww          , Gg          , Gg          , Gg          , Gg          , Gg          , Gg          , Ww          , Ww          
Gg          , Gg          , Gg          , Gg          , Gg          , Gg          , Ww          , Gll         , Gll         , Gll         , Ch          , Gll         , Ch          , Gll         , Ch          , Rb          , Rb          , Rb          , Rb          , Rb          , Rb          , Ch          , Ch          , Ch          , Rb          , Ch          , Rb          , Ch          , Ch          , Ch          , Gll         , Gll         , Gll         , Gll         , Gll         , Gll         , Gll         , Ww          , Ww          , Gg          , Gg          , Gg          , Ww          , Ww          , Ww          , Ww          
Gg          , Gg          , Gg          , Gg          , Gg          , Gg          , Ww          , Gll         , Gll         , Ch          , Ch          , Ch          , Rb          , Ch          , Rb          , Rb          , Rb          , Rb          , Rb          , Rb          , Rb          , Rb          , Rr          , Rb          , Rb          , Rb          , Rb          , Rb          , Rb          , Ch          , Ch          , Ch          , Ch          , Ch          , Ch          , Gll         , Gll         , Gll         , Ww          , Ww          , Ww          , Ww          , Ww          , Ww          , Ww          , Ww          
Gg          , Gg          , Gg          , Gg          , Gg          , Ww          , Ww          , Gll         , Gll         , Ch          , Rb          , Rb          , Rb          , Rb          , Rb          , Rb          , Rb          , Rb          , Rb          , Rb          , Rb          , Rr          , Rr          , Rr          , Rb          , Rb          , Rb          , Rb          , Rb          , Rb          , Rb          , Rb          , Rb          , Rb          , Ch          , Gll         , Gll         , Ww          , Ww          , Ww          , Ww          , Ww          , Gg          , Ww          , Gg          , Gg          
Gg          , Gg          , Gg          , Gg          , Ww          , Ww          , Gll         , Gll         , Gll         , Ch          , Rb          , Rb          , Rb          , Rb          , Rb          , Rb          , Rb          , Rb          , Rb          , Rb          , Rb          , Rr          , Rr          , Rr          , Rb          , Rb          , Rb          , Rb          , Rb          , Rb          , Rb          , Rb          , Rb          , Rb          , Rb          , Ch          , Gll         , Gll         , Gll         , Ww          , Gg          , Gg          , Gg          , Gg          , Gg          , Gg          
Gg          , Gg          , Gg          , Gg          , Ww          , Gll         , Gll         , Gll         , Ch          , Ch          , Rb          , Rb          , Rb          , Rb          , Rb          , Rb          , Rb          , Rb          , Rb          , Rb          , Rb          , Rb          , Rr          , Rb          , Rb          , Rb          , Rb          , Rb          , Rb          , Rb          , Rb          , Rb          , Rb          , Rb          , Rb          , Ch          , Gll         , Gll         , Gll         , Ww          , Ww          , Gg          , Gg          , Gg          , Gg          , Gg          
Gg          , Gg          , Gg          , Gg          , Ww          , Gll         , Gll         , Gll         , Ch          , Ch          , Rb          , Rb          , Rb          , Rb          , Rb          , Rb          , Rb          , Rb          , Rb          , Rb          , Rb          , Rb          , Rr          , Rb          , Rb          , Rb          , Rb          , Rb          , Rb          , Rb          , Rb          , Rb          , Rb          , Rb          , Rb          , Ch          , Gll         , Gll         , Gll         , Gll         , Ww          , Gg          , Gg          , Gg          , Gg          , Gg          
Gg          , Gg          , Gg          , Gg          , Ww          , Gll         , Ch          , Ch          , Rb          , Rb          , Rb          , Rb          , Rb          , Rb          , Rb          , Rb          , Rb          , Rb          , Rb          , Rb          , Rb          , Rb          , Rr          , Rb          , Rb          , Rb          , Rb          , Rb          , Rb          , Rb          , Rb          , Rb          , Rb          , Rb          , Rb          , Ch          , Ch          , Gll         , Gll         , Gll         , Gll         , Ww          , Ww          , Gg          , Gg          , Gg          
Gg          , Gg          , Gg          , Gg          , Ww          , Gll         , Ch          , Rb          , Rb          , Rb          , Rb          , Rb          , Rb          , Rb          , Rb          , Rb          , Rb          , Rb          , Rb          , Rb          , Rr          , Rb          , Rr          , Rb          , Rr          , Rb          , Rb          , Rb          , Rb          , Rb          , Rb          , Rb          , Rb          , Rb          , Rb          , Rb          , Ch          , Gll         , Gll         , Gll         , Gll         , Ww          , Ww          , Gg          , Gg          , Gg          
Gg          , Gg          , Gg          , Gg          , Ww          , Gll         , Ch          , Ch          , Rb          , Rb          , Rb          , Rb          , Rb          , Rb          , Rb          , Rb          , Rb          , Rb          , Rb          , Rb          , Ww^Bsb|     , Rr          , Ww          , Rr          , Ww^Bsb|     , Rb          , Rb          , Rb          , Rb          , Rb          , Rb          , Rb          , Rb          , Rb          , Rb          , Rb          , Ch          , Ch          , Ch          , Gll         , Gll         , Ww          , Ww          , Gg          , Gg          , Gg          
Gg          , Gg          , Gg          , Gg          , Ww          , Gll         , Ww          , Ch          , Rb          , Rb          , Rb          , Rb          , Rb          , Rb          , Rb          , Rb          , Rb          , Rb          , Ww          , Ww          , Ch          , Ww          , Ch          , Ww          , Ch          , Ww          , Ww          , Rb          , Rb          , Rb          , Rb          , Rb          , Rb          , Rb          , Rb          , Rb          , Rb          , Ch          , Ch          , Gll         , Gll         , Ww          , Ww          , Gg          , Gg          , Gg          
Gg          , Gg          , Gg          , Gg          , Gg          , Ww          , Ww          , Ch          , Rb          , Rb          , Rb          , Rb          , Rb          , Rb          , Rb          , Rb          , Ww          , Ww          , Ch          , Ch          , Rr          , Ch          , Rr^Vhc      , Ch          , Rr          , Ch          , Ch          , Ww          , Ww          , Rb          , Rb          , Rb          , Rb          , Rb          , Rb          , Rb          , Rb          , Rb          , Ch          , Gll         , Gll         , Ww          , Ww          , Gg          , Gg          , Gg          
Gg          , Gg          , Gg          , Gg          , Gg          , Ww          , Gll         , Ch          , Ch          , Rb          , Rb          , Rb          , Rb          , Rb          , Rb          , Ww          , Ch          , Ch          , Rr^Vhc      , Rr          , Rr          , Rr          , Rr          , Rr          , Rr          , Rr          , Rr^Vhc      , Ch          , Ch          , Ww          , Rb          , Rb          , Rb          , Rb          , Rb          , Rb          , Rb          , Rb          , Ch          , Gll         , Gll         , Ww          , Ww          , Gg          , Gg          , Gg          
Gg          , Gg          , Gg          , Gg          , Gg          , Ww          , Gll         , Gll         , Ch          , Rb          , Rb          , Rb          , Rb          , Rb          , Rb          , Ww          , Ch          , Rr          , Rr          , Rr          , Ch          , Rr          , Rr          , Rr          , Ch          , Rr          , Rr          , Rr          , Ch          , Ww          , Rb          , Rb          , Rb          , Rb          , Rb          , Rb          , Rb          , Rb          , Ch          , Gll         , Gll         , Ww          , Gg          , Gg          , Gg          , Gg          
Gg          , Gg          , Gg          , Gg          , Gg          , Ww          , Ww          , Gll         , Ch          , Ch          , Rb          , Rb          , Rb          , Rb          , Rb          , Ww          , Ch          , Rr^Vd       , Rr          , Rr          , Rr          , Kv          , Kv          , Kv          , Rr          , Rr          , Rr          , Rr^Vd       , Ch          , Ww          , Rb          , Rb          , Rb          , Rb          , Rb          , Rb          , Rb          , Rb          , Ch          , Ch          , Gll         , Ww          , Gg          , Gg          , Gg          , Gg          
Gg          , Gg          , Gg          , Gg          , Gg          , Gg          , Ww          , Gll         , Gll         , Ch          , Rb          , Rb          , Rb          , Rb          , Rb          , Ww          , Ch          , Rr          , Rr          , Rr          , Rr          , Rr          , Kh          , Rr          , Rr          , Rr          , Rr          , Rr          , Ch          , Ww          , Rb          , Rb          , Rb          , Rb          , Rb          , Rb          , Rb          , Rb          , Ch          , Gll         , Ww          , Ww          , Gg          , Gg          , Gg          , Gg          
Gg          , Gg          , Gg          , Gg          , Gg          , Gg          , Ww          , Ww          , Gll         , Ch          , Rb          , Rb          , Rb          , Rb          , Rb          , Ww          , Ch          , Rr^Vd       , Rr          , Rr          , Rr          , Rr          , Kv          , Rr          , Rr          , Rr          , Rr          , Rr^Vd       , Ch          , Ww          , Rb          , Rb          , Rb          , Rb          , Rb          , Rb          , Rb          , Rb          , Ch          , Gll         , Ww          , Ww          , Gg          , Gg          , Gg          , Gg          
Gg          , Gg          , Gg          , Gg          , Gg          , Ww          , Gll         , Gll         , Gll         , Ch          , Rb          , Rb          , Rb          , Rb          , Rb          , Ww          , Ch          , Rr          , Rr          , Rr          , Ch          , Kv          , Rr          , Kv          , Ch          , Rr          , Rr          , Rr          , Ch          , Ww          , Rb          , Rb          , Rb          , Rb          , Rb          , Rb          , Rb          , Rb          , Ch          , Gll         , Gll         , Ww          , Gg          , Gg          , Gg          , Gg          
Gg          , Gg          , Gg          , Gg          , Gg          , Ww          , Ww          , Gll         , Gll         , Ch          , Rb          , Rb          , Rb          , Rb          , Rb          , Ww          , Ch          , Rr^Vhc      , Rr          , Rr          , Rr          , Rr          , Rr          , Rr          , Rr          , Rr          , Rr          , Rr^Vhc      , Ch          , Ww          , Rb          , Rb          , Rb          , Rb          , Rb          , Rb          , Rb          , Rb          , Ch          , Gll         , Gll         , Ww          , Gg          , Gg          , Gg          , Gg          
Gg          , Gg          , Gg          , Gg          , Gg          , Ww          , Ww          , Gll         , Gll         , Ch          , Ch          , Rb          , Rb          , Rb          , Rb          , Ww          , Ch          , Rr          , Rr          , Rr          , Rr^Vhc      , Rr          , Rr^Vhc      , Rr          , Rr^Vhc      , Rr          , Rr          , Rr          , Ch          , Ww          , Rb          , Rb          , Rb          , Rb          , Rb          , Rb          , Rb          , Rb          , Ch          , Gll         , Gll         , Ww          , Gg          , Gg          , Gg          , Gg          
Gg          , Gg          , Gg          , Gg          , Gg          , Ww          , Ww          , Gll         , Gll         , Gll         , Ch          , Rb          , Rb          , Rb          , Rb          , Ww          , Ch          , Rr          , Ch          , Rr          , Ch          , Rr          , Ch          , Rr          , Ch          , Rr          , Ch          , Rr          , Ch          , Ww          , Rb          , Rb          , Rb          , Rb          , Rb          , Rb          , Rb          , Rb          , Ch          , Gll         , Gll         , Ww          , Gg          , Gg          , Gg          , Gg          
Gg          , Gg          , Gg          , Gg          , Gg          , Gg          , Ww          , Gll         , Gll         , Gll         , Ch          , Rb          , Rb          , Rb          , Rb          , Ww          , Ww          , Ch          , Ww          , Ch          , Ww          , Ch          , Ww          , Ch          , Ww          , Ch          , Ww          , Ch          , Ww          , Ww          , Rb          , Rb          , Rb          , Rb          , Rb          , Rb          , Rb          , Ch          , Ch          , Gll         , Gll         , Ww          , Gg          , Gg          , Gg          , Gg          
Gg          , Gg          , Gg          , Gg          , Gg          , Gg          , Ww          , Gll         , Gll         , Gll         , Ch          , Rb          , Rb          , Rb          , Rb          , Rb          , Rb          , Ww          , Rb          , Ww          , Rb          , Ww          , Rb          , Ww          , Rb          , Ww          , Rb          , Ww          , Rb          , Rb          , Rb          , Rb          , Rb          , Rb          , Rb          , Rb          , Rb          , Ch          , Gll         , Gll         , Ww          , Ww          , Gg          , Gg          , Gg          , Gg          
Gg          , Gg          , Gg          , Gg          , Gg          , Gg          , Ww          , Gll         , Gll         , Gll         , Ch          , Rb          , Rb          , Rb          , Rb          , Rb          , Rb          , Rb          , Rb          , Rb          , Rb          , Rb          , Rb          , Rb          , Rb          , Rb          , Rb          , Rb          , Rb          , Rb          , Rb          , Rb          , Rb          , Rb          , Rb          , Rb          , Ch          , Ch          , Gll         , Gll         , Ww          , Gg          , Gg          , Gg          , Gg          , Gg          
Gg          , Gg          , Gg          , Gg          , Gg          , Gg          , Ww          , Gll         , Gll         , Gll         , Gll         , Ch          , Ch          , Rb          , Rb          , Rb          , Rb          , Rb          , Rb          , Rb          , Rb          , Rb          , Rb          , Rb          , Rb          , Rb          , Rb          , Rb          , Rb          , Rb          , Rb          , Rb          , Rb          , Rb          , Ch          , Ch          , Ch          , Gll         , Gll         , Ww          , Ww          , Gg          , Gg          , Gg          , Gg          , Gg          
Gg          , Gg          , Gg          , Gg          , Gg          , Gg          , Gg          , Ww          , Ww          , Gll         , Gll         , Gll         , Ch          , Rb          , Rb          , Rb          , Rb          , Rb          , Rb          , Rb          , Rb          , Rb          , Rb          , Rb          , Ch          , Ch          , Ch          , Ch          , Ch          , Rb          , Rb          , Ch          , Ch          , Ch          , Gll         , Ch          , Gll         , Gll         , Gll         , Ww          , Ww          , Gg          , Gg          , Gg          , Gg          , Gg          
Gg          , Gg          , Gg          , Gg          , Gg          , Gg          , Gg          , Gg          , Gg          , Ww          , Gll         , Gll         , Gll         , Ch          , Ch          , Ch          , Ch          , Rb          , Ch          , Ch          , Ch          , Ch          , Ch          , Ch          , Ch          , Gll         , Gll         , Gll         , Gll         , Ch          , Ch          , Ch          , Gll         , Gll         , Gll         , Gll         , Ww          , Gll         , Ww          , Ww          , Gg          , Gg          , Gg          , Gg          , Gg          , Gg          
Gg          , Gg          , Gg          , Gg          , Gg          , Gg          , Gg          , Gg          , Gg          , Ww          , Ww          , Gll         , Gll         , Gll         , Gll         , Gll         , Gll         , Ch          , Gll         , Gll         , Gll         , Gll         , Gll         , Ch          , Gll         , Gll         , Gll         , Gll         , Gll         , Gll         , Gll         , Gll         , Gll         , Gll         , Gll         , Gll         , Ww          , Ww          , Gg          , Gg          , Gg          , Gg          , Gg          , Gg          , Gg          , Gg          
Gg          , Gg          , Gg          , Gg          , Gg          , Gg          , Gg          , Gg          , Gg          , Gg          , Gg          , Ww          , Ww          , Ww          , Ww          , Gll         , Ww          , Gll         , Ww          , Gll         , Ww          , Gll         , Gll         , Gll         , Gll         , Gll         , Ww          , Gll         , Ww          , Gll         , Ww          , Gll         , Ww          , Ww          , Ww          , Ww          , Gg          , Gg          , Gg          , Gg          , Gg          , Gg          , Gg          , Gg          , Gg          , Gg          
Gg          , Gg          , Gg          , Gg          , Gg          , Gg          , Gg          , Gg          , Gg          , Gg          , Gg          , Gg          , Gg          , Gg          , Gg          , Ww          , Gg          , Ww          , Gg          , Ww          , Gg          , Ww          , Ww          , Ww          , Ww          , Ww          , Gg          , Ww          , Gg          , Ww          , Ww          , Ww          , Gg          , Ww          , Gg          , Gg          , Gg          , Gg          , Gg          , Gg          , Gg          , Gg          , Gg          , Gg          , Gg          , Gg          
Gg          , Gg          , Gg          , Gg          , Gg          , Gg          , Gg          , Gg          , Gg          , Gg          , Gg          , Gg          , Gg          , Gg          , Gg          , Gg          , Gg          , Gg          , Gg          , Gg          , Gg          , Gg          , Gg          , Gg          , Gg          , Gg          , Gg          , Gg          , Gg          , Gg          , Gg          , Gg          , Gg          , Gg          , Gg          , Gg          , Gg          , Gg          , Gg          , Gg          , Gg          , Gg          , Gg          , Gg          , Gg          , Gg          
Gg          , Gg          , Gg          , Gg          , Gg          , Gg          , Gg          , Gg          , Gg          , Gg          , Gg          , Gg          , Gg          , Gg          , Gg          , Gg          , Gg          , Gg          , Gg          , Gg          , Gg          , Gg          , Gg          , Gg          , Gg          , Gg          , Gg          , Gg          , Gg          , Gg          , Gg          , Gg          , Gg          , Gg          , Gg          , Gg          , Gg          , Gg          , Gg          , Gg          , Gg          , Gg          , Gg          , Gg          , Gg          , Gg          
Gg          , Gg          , Gg          , Gg          , Gg          , Gg          , Gg          , Gg          , Gg          , Gg          , Gg          , Gg          , Gg          , Gg          , Gg          , Gg          , Gg          , Gg          , Gg          , Gg          , Gg          , Gg          , Gg          , Gg          , Gg          , Gg          , Gg          , Gg          , Gg          , Gg          , Gg          , Gg          , Gg          , Gg          , Gg          , Gg          , Gg          , Gg          , Gg          , Gg          , Gg          , Gg          , Gg          , Gg          , Gg          , Gg          
Gg          , Gg          , Gg          , Gg          , Gg          , Gg          , Gg          , Gg          , Gg          , Gg          , Gg          , Gg          , Gg          , Gg          , Gg          , Gg          , Gg          , Gg          , Gg          , Gg          , Gg          , Gg          , Gg          , Gg          , Gg          , Gg          , Gg          , Gg          , Gg          , Gg          , Gg          , Gg          , Gg          , Gg          , Gg          , Gg          , Gg          , Gg          , Gg          , Gg          , Gg          , Gg          , Gg          , Gg          , Gg          , Gg          
Gg          , Gg          , Gg          , Gg          , Gg          , Gg          , Gg          , Gg          , Gg          , Gg          , Gg          , Gg          , Gg          , Gg          , Gg          , Gg          , Gg          , Gg          , Gg          , Gg          , Gg          , Gg          , Gg          , Gg          , Gg          , Gg          , Gg          , Gg          , Gg          , Gg          , Gg          , Gg          , Gg          , Gg          , Gg          , Gg          , Gg          , Gg          , Gg          , Gg          , Gg          , Gg          , Gg          , Gg          , Gg          , Gg          
Gg          , Gg          , Gg          , Gg          , Gg          , Gg          , Gg          , Gg          , Gg          , Gg          , Gg          , Gg          , Gg          , Gg          , Gg          , Gg          , Gg          , Gg          , Gg          , Gg          , Gg          , Gg          , Gg          , Gg          , Gg          , Gg          , Gg          , Gg          , Gg          , Gg          , Gg          , Gg          , Gg          , Gg          , Gg          , Gg          , Gg          , Gg          , Gg          , Gg          , Gg          , Gg          , Gg          , Gg          , Gg          , Gg          
Gg          , Gg          , Gg          , Gg          , Gg          , Gg          , Gg          , Gg          , Gg          , Gg          , Gg          , Gg          , Gg          , Gg          , Gg          , Gg          , Gg          , Gg          , Gg          , Gg          , Gg          , Gg          , Gg          , Gg          , Gg          , Gg          , Gg          , Gg          , Gg          , Gg          , Gg          , Gg          , Gg          , Gg          , Gg          , Gg          , Gg          , Gg          , Gg          , Gg          , Gg          , Gg          , Gg          , Gg          , Gg          , Gg          
Gg          , Gg          , Gg          , Gg          , Gg          , Gg          , Gg          , Gg          , Gg          , Gg          , Gg          , Gg          , Gg          , Gg          , Gg          , Gg          , Gg          , Gg          , Gg          , Gg          , Gg          , Gg          , Gg          , Gg          , Gg          , Gg          , Gg          , Gg          , Gg          , Gg          , Gg          , Gg          , Gg          , Gg          , Gg          , Gg          , Gg          , Gg          , Gg          , Gg          , Gg          , Gg          , Gg          , Gg          , Gg          , Gg          
Gg          , Gg          , Gg          , Gg          , Gg          , Gg          , Gg          , Gg          , Gg          , Gg          , Gg          , Gg          , Gg          , Gg          , Gg          , Gg          , Gg          , Gg          , Gg          , Gg          , Gg          , Gg          , Gg          , Gg          , Gg          , Gg          , Gg          , Gg          , Gg          , Gg          , Gg          , Gg          , Gg          , Gg          , Gg          , Gg          , Gg          , Gg          , Gg          , Gg          , Gg          , Gg          , Gg          , Gg          , Gg          , Gg          
