border_size=1
usage=map

Mm          , Mm          , Mm          , Mm          , Mm          , Gg          , Gg          , Gg          , Ww          , Gg          , Hh^Fms      , Hh^Fms      , Hh^Fmf      , Mm^Xm       , Mm          , Xu          , Mm^Xm       , Mm^Xm       , Md          , Md          , Mm^Xm       , Mm^Xm       , Md          , Md          , Md          , Mm^Xm       
Mm          , 3 Kh        , Ch          , Ch          , Ch          , Hh^Vhh      , Gg          , Ww          , Ww          , Hh^Fms      , Ggf         , Hh^Fdf      , Hh^Fms      , Mm^Xm       , Hh^Fp       , Mm^Xm       , Hh          , Mm^Xm       , Md          , Mm^Xm       , Mm^Xm       , Mm^Xm       , Mm^Xm       , Mm^Xm       , Md          , Md          
Mm          , Ch          , Mm^Xm       , Mm^Xm       , Gs^Vht      , Rd          , Rd          , Gg          , Ggf         , Gg^Wm       , Ggf         , Gg          , Gs^Fmf      , Mm          , Mm          , Hh^Fmw      , Md          , Md          , Md          , Mm^Xm       , Mm^Xm       , Md          , Md          , Md          , Mm^Xm       , Md          
Gs^Fms      , Rd          , Gg^Ve       , Mm          , Mm          , Gg          , Hh^Fp       , Rd          , Rd          , Rd          , Rd          , Rd          , Rd          , Rd          , Rd          , Rd          , Gg          , Md          , Mm^Xm       , Mm^Xm       , Md          , Md          , Mm^Xm       , Mm^Xm       , Mm^Xm       , Md          
Gs^Fms      , Rd          , Rd          , Hh^Fds      , Gs^Fms      , Hh^Fdw      , Mm          , Gs          , Gs          , Gs          , Mm          , Gg          , Mm^Vhh      , Gg          , Rd          , Rd          , Gg^Fet      , Ggf         , Ggf         , Mm^Xm       , Mm^Xm       , Md          , Md          , Md          , Md          , Mm^Xm       
Gs^Fms      , Gs^Fmf      , Gs^Fms      , Rd          , Gs^Fp       , Hh^Fmf      , Hh^Fms      , Hh^Fms      , Ggf         , Ggf         , Mm          , Mm          , Chr         , Mm          , Mm          , Rd          , Rd          , Rd          , Hh^Fmw      , Mm^Xm       , Mm^Xm       , Md          , Md          , Mm^Xm       , Md          , Md          
Gs^Fms      , Gs^Fms      , Wo          , Wwf^Bw|     , Wwr         , Ss          , Ggf         , Ggf         , Hh^Fmf      , Mm^Xm       , Mm          , Mm          , 2 Kh        , Chr         , Mm          , Mm          , Gg          , Rd          , Md          , Md          , Md          , Mm^Xm       , Mm^Xm       , Mm^Xm       , Mm^Xm       , Mm^Xm       
Wo          , Wo          , Wo          , Wwr^Bw|     , Wwr         , Wwr         , Ww          , Hh^Fmf      , Ss          , Hh^Fds      , Mm          , Chr         , Mm          , Mm^Vhh      , Mm^Xm       , Hh^Fds      , Gg          , Rd          , Rd          , Rp          , Md          , Md          , Mm^Xm       , Mm^Xm       , Mm          , Mm^Xm       
Wo          , Wo          , Rd          , Rd          , Gg^Fet      , Ggf         , Ww          , Ww          , Ww          , Ww          , Hh^Fp       , Mm          , Mm          , Mm          , Ww          , Hh^Fp       , Hh^Fms      , Hh^Fms      , Hh^Vhh      , Md          , Hh^Fds      , Uu^Uf       , Hh^Fp       , Mm          , Mm          , Mm          
Ss          , Ss          , Rd          , Ggf         , Ss          , Ww          , Ss          , Ww          , Gg          , Hh^Fds      , Hh^Fds      , Hh^Fds      , Hh^Fds      , Hh^Fmf      , Hh^Fmf      , Ww          , Gg^Fet      , Hh^Fms      , Mm          , Hh^Fmf      , Re          , Hh^Fmf      , Hh^Fms      , Mm          , Mm^Xm       , Mm^Xm       
Wo          , Ss^Vhs      , Wwf         , Ww          , Ww          , Ss^Vm       , Ss          , Ss          , Gg          , Gs^Fmf      , Gs^Fmf      , Gs^Fmf      , Gs^Fp       , Hh^Fds      , Gg          , Gg          , Gg          , Hh^Fms      , Chw         , Wwf         , Ww          , Re          , Ggf         , Hh^Fds      , Mm^Xm       , Mm^Xm       
Ss          , Wo          , Wwf         , Wo          , Wo^Bw/      , Ww^Bw/      , Ww^Vm       , Ss          , Hh^Fp       , Gg          , Gg          , Gs^Fp       , Gg          , Gs^Fp       , Rd          , Rd          , Rd          , Rd          , Ds          , Ww          , Ww          , Ww          , 4 Mm^Kov    , Mm^Cov      , Mm^Cov      , Mm          
Ss          , Chw         , 1 Khw       , Chw         , Chw         , Wo          , Wwr         , Gs          , Rd          , Gg          , Rd          , Rd          , Rd          , Rd          , Hh^Fms      , Rd          , Hh^Fms      , Rd          , Gg^Wm       , Hh          , Mm^Xm       , Mm          , Mm          , Mm^Cov      , Mm          , Mm          
Ss          , Ss          , Ss          , Chw         , Ss          , Wo          , Ss          , Rd          , Hh^Fms      , Hh^Fms      , Hh^Fms      , Hh^Fp       , Hh^Fms      , Hh^Fms      , Hh^Fms      , Hh^Fms      , Hh^Fdf      , Hh^Fp       , Hh^Fdf      , Mm^Xm       , Mm^Xm       , Mm^Xm       , Mm^Xm       , Mm^Xm       , Mm^Xm       , Mm          
