border_size=1
usage=map

Hh^Fp       , Hh^Fp       , Hh^Fp       , Gg          , Gg          , Gg          , Gg^Eff      , Gg^Eff      , Gg^Eff      , Md          , Md          , Md          , Hh^Fp       , Hh          , Hh^Fp       , Rrc         , Gg          , Gg          , Gg          , Gg          , Gg          , Gg          , Gg          , Gg          , Gg          , Gg          , Gll^Fmf     , Gg          , Gll^Fmf     , Gll^Fmf     , Gll^Fmf     , Gll^Fmf     , Gd^Fmw      , Gd          , Gll         , Gs^Fdw      , Ha          , Ha^Fpa      , Ha^Fpa      , Ha^Fpa      , Ha          , Ms^Xm       , Ms^Xm       , Ms^Xm       
Hh^Fp       , Hh^Fms      , Gg          , Gg          , Gg^Eff      , Gg^Eff      , Gg^Eff      , Gg^Eff      , Gg          , Md          , Md          , Md          , Hhd         , Hh^Fp       , Rrc         , Rrc         , Rrc         , Gg          , Gg          , Gg          , Gg          , Gg          , Gg          , Gg          , Gg          , Gs          , Gs          , Gs^Fdw      , Gs^Fdw      , Gs^Fdw      , Gd^Fdf      , Gll         , Gll         , Aa^Fpa      , Gs^Fdw      , Aa^Fpa      , Aa^Fda      , Ha          , Aa          , Aa          , Aa          , Ha^Fpa      , Ha^Fma      , Ms^Xm       
Gg          , Gg          , Gg          , Gg          , Gg          , Gg^Eff      , Gg^Eff      , Gd^Eff      , Gd          , Gd          , Md^Xm       , Md^Xm       , Hhd^Fdw     , Hh^Fds      , Rrc         , 1 Ch        , Rrc         , Gg          , Gg          , Gg          , Gg^Gvs      , Gg          , Gg          , Gg          , Gs^Fms      , Gll^Fp      , Gs          , Gg          , Hhd^Fmf     , Gll^Fmf     , Hhd^Fmf     , Gd^Fdf      , Gll         , Gd^Fetd     , Aa^Fda      , Gs^Fdw      , Rr          , Ha          , Aa^Es       , Ha^Fpa      , Aa          , Aa^Es       , Ms          , Ms          
Hh^Fms      , Gg          , Gg          , Gg          , Gs^Fds      , Gd          , Gd          , Gd          , Gg          , Gd          , Md          , Md          , Hh^Fp       , Hh^Fds      , Hh^Fp       , Rrc         , Rp          , Gg          , Gg^Gvs      , Gg^Gvs      , Gg^Gvs      , Gg^Gvs      , Gg          , Gg          , Gs^Fms      , Gg          , Gg          , Gs          , Gll^Fmf     , Gs^Fdw      , Gll         , Gll         , Gg          , Gll         , Gd          , Gll         , Rr          , Rr          , Rp          , Rr          , Rr          , Rr          , Mm          , Ai          
Hh^Fms      , Gg          , Gg          , Gs^Fds      , Gg          , Gs^Fds      , Gs          , Gs          , Gg          , Gd          , Hhd^Fdw     , Hh^Fp       , Hhd^Fdw     , Hh^Fp       , Gg          , Rp          , Rp          , Gg          , Gg          , Gg^Gvs      , Gg          , Gg          , Gg          , Gs^Fds      , Gs^Fms      , Gll^Fp      , Gs^Fds      , Gg          , Gg          , Gll^Fmf     , Gll^Fmf     , Gll         , Gll^Fmf     , Ce          , Gs          , Gd          , Rr          , Gs^Fdw      , Aa^Fma      , Rp          , Uu^Es       , Mm          , Mm          , Mm          
Md          , Hh^Fms      , Gg          , Gs^Fds      , Gg          , Gs^Fds      , Gs          , Gs          , Gd          , Gd          , Hhd         , Md          , Hh^Fp       , Hh^Fp       , Gg          , Gs^Fds      , Gs^Fds      , Rp          , Rp          , Gg          , Gg          , Gg          , Gg          , Gs^Fms      , Gg          , Gs^Fms      , Gs          , Gll^Fp      , Gs          , Gll^Fmf     , Gs          , Rr          , Rr          , Rr          , Rr          , Rr          , Mm          , Mm          , Ms          , Rp          , Rr          , Hhd^Fdw     , Hhd^Fdw     , Ms^Xm       
Md          , Hh^Fms      , Gs          , Gs          , Gs          , Gd          , Gs^Gvs      , Gs          , Gs          , Gg          , Ss          , Hh^Fp       , Hh^Fp       , Hh^Fp       , Gll         , Gs^Fds      , Gg          , Rp          , Rp          , Gg          , Gg          , Gg          , Gg          , Gg          , Gg^Gvs      , Gg          , Gg          , Gg          , Gg          , Gs          , Rr          , Rr          , Gll^Fmf     , Gs          , Gll         , Gs          , Aa^Fda      , Mm          , Aa^Fma      , Ha          , Aa^Fma      , Rr          , Rp          , Mm          
Md          , Md          , Gs          , Gs          , Gs^Gvs      , Gs^Gvs      , Gg^Gvs      , Gs^Gvs      , Gg^Fet      , Sm          , Sm          , Sm          , Hh^Fp       , Hh^Fp       , Gg          , Gll         , Gs^Fms      , Gs^Fds      , Rp          , Gg          , Rp          , Gg          , Gg          , Gg^Gvs      , Gg^Gvs      , Gg^Gvs      , Gg^Gvs      , Gg          , Rr          , Rr          , Gll^Fp      , Gs          , Gs^Fdw      , Gll^Fmf     , Gs          , Gll         , Hhd^Fdw     , Ha^Fma      , Gs^Fdw      , Mm          , Ha^Fda      , Aa^Es       , Rp          , Rp          
Hh^Fp       , Hh^Fp       , Gs^Gvs      , Gg^Gvs      , Gs^Gvs      , Gg^Gvs      , Gg          , Gg          , Wwr         , Ss          , Wwr         , Ww          , Gg^Fet      , Gd          , Gg          , Gll         , Gg          , Gg          , Gg          , Rp          , Gg^Efm      , Rp          , Gg^Efm      , Gg          , Rr          , Gg^Gvs      , Rr          , Rr          , Gg          , Gll^Fp      , Gs          , Gll^Fp      , Gs          , Gs^Fdw      , Gd^Fmw      , Gll         , Gs          , Gd^Fmw      , Gs          , Gll         , Gs^Fdw      , Rp          , Rp          , Ms          
Gs          , Gs          , Gs          , Gs^Gvs      , Gs          , Gg          , Gg          , Wwg         , Wwg         , Wwr         , Ww          , Ww          , Ww          , Ww          , Gll         , Gs^Fds      , Gg          , Gg          , Gg          , Gg          , Ch          , Rp          , Ch          , Rr          , Gg          , Rr          , Gg          , Gg          , Gs^Fms      , Gs^Fms      , Gs^Fds      , Gs^Fms      , Gs^Fms      , Hhd^Fmf     , Gd^Fmw      , Hhd^Fmf     , Hhd^Fmf     , Gd^Fmw      , Gd^Fmw      , Ha^Fda      , Rp          , Rp          , Hhd^Fdw     , Mm          
Hh^Fp       , Gs          , Gg          , Gg          , Gg          , Gg          , Gg          , Wwg         , Ww          , Ww          , Ww          , Ww          , Ww          , Ww          , Gll         , Gs^Fds      , Gs^Fds      , Gs^Fds      , Gs^Fms      , Gg^Efm      , Ch          , Kh          , Ch          , Gg^Efm      , Gg          , Gg          , Gg          , Gll^Fp      , Gll^Fp      , Gs^Fms      , Gs          , Gs          , Gs          , Gd^Fdf      , Gll^Fmf     , Gd^Fetd     , Gd^Fdf      , Gg          , Rp          , Rp          , Gd^Fmw      , Gll^Fmf     , Gll         , Ha^Fpa      
Ww          , Gg          , Gg          , Wwrg        , Wwg         , Wwrg        , Ww          , Ww          , Wo          , Wo          , Wo          , Ww          , Ww          , Gll         , Gll         , Gg          , Gll         , Gs^Fms      , Gs^Fms      , Gg          , Gg^Efm      , Rp          , Gg^Efm      , Gg^Efm      , Gg^Eff      , Gg^Eff      , Gg^Eff      , Gg          , Hh^Fms      , Gs^Fds      , Hh^Fp       , Hh^Fds      , Hh^Fds      , Gll^Fmf     , Chr         , Gd^Fdf      , Rb          , Gll^Fmf     , Rp          , Rp          , Rd          , Gs          , Gll^Fmf     , Gs^Fdw      
Ww          , Wwg^Bw|r    , Ww          , Ww          , Ww          , Ww          , Ww          , Wwr         , Ww          , Wo          , Ww          , Ww          , Ww          , Ww          , Ww          , Ww          , Ww          , Gg          , Ww          , Gg          , Rr          , Rp          , Gg          , Gg          , Gg^Gvs      , Gg^Gvs      , Gg^Gvs      , Gg^Eff      , Gg^Eff      , Hh^Fp       , Hh^Fp       , Mm          , Mm          , Mm          , Chr         , Rp          , Hhd^Fmf     , Rb          , Rp          , Gll^Fmf     , Hhd^Fdw     , Gd^Fmw      , Mm          , Mm          
Gg          , Ww^Bw|r     , Gg          , Ww          , Gs^Fms      , Gs^Fms      , Gs^Fms      , Ww          , Ww          , Ww          , Gs^Fms      , Ww          , Gs^Fms      , Ww          , Gs^Fms      , Ww          , Gs^Fms      , Ww          , Ww          , Ww          , Gs          , Rp          , Rr          , Gg^Eff      , Gg^Eff      , Gg^Gvs      , Gg^Eff      , Gs^Eff      , Hh^Fms      , Hh          , Mm          , Mm          , Mm          , Hh          , Mm          , Hhd^Fmf     , Mm          , Hh          , Mm          , Rp          , Rp          , Hh          , Mm          , Mm          
Gg          , Re          , Gs^Fms      , Gs^Fms      , Gs^Fms      , Gs^Fms      , Gs^Fms      , Gs^Fms      , Gs^Fms      , Gs^Fms      , Gg          , Gs          , Gs^Fms      , Gs^Fms      , Gg          , Gs^Fms      , Gg          , Gs^Fms      , Gs^Fms      , Ww          , Re          , Re          , Rr          , Gg          , Gg          , Gg^Eff      , Gg^Gvs      , Gg          , Gs^Gvs      , Hh          , Gg^Gvs      , Hh          , Sm          , Hh^Fds      , Sm          , Hh          , Hh^Fds      , Gd^Fmw      , Gs^Fdw      , Gs^Fdw      , Rb          , Hh^Fds      , Hh          , Mm          
Gg          , Re          , Gd          , Gs          , Re          , Gs^Fms      , Gs^Fms      , Gs^Fms      , Gs^Fds      , Hh^Fp       , Hh^Fds      , Gg          , Gs^Fms      , Gg          , Gg          , Gs^Fms      , Gd          , Rd          , Rd          , Ww^Bw/      , Ww          , Re          , Rr          , Gg          , Gg          , Gg          , Gg^Gvs      , Gg^Gvs      , Gs^Gvs      , Gs^Gvs      , Gs^Gvs      , Wwg         , Ww^Ewf      , Wwf         , Wwrg        , Gs^Fds      , Hhd^Fdf     , Gd          , Gs          , Gs          , Rp          , Gll^Fmf     , Gs^Fdw      , Gs^Fdw      
Gs^Fms      , Gs^Fms      , Gg          , Re          , Gg          , Re          , Re          , Gs^Fds      , Gs^Fms      , Hh^Fp       , Gg          , Gs^Fms      , Gg          , Gs^Fms      , Re          , Re          , Gg          , Gs^Fms      , Gg          , Ww          , Ww          , Gg^Fet      , Rr          , Rp          , Rp          , Rp          , Rp          , Gs          , Rp          , Gs^Gvs      , Gs^Fds      , Ww          , Hh^Fds      , Ww^Ewl      , Gd          , Hh^Fds      , Mm          , Gll^Fmf     , Rb          , Rp          , Gg          , Gs          , Gs^Fms      , Hh          
Gs^Fms      , Gs^Fms      , Gll^Fp      , Gll^Fp      , Gll^Fp      , Gs^Fms      , Rb          , Re          , Re          , Gs^Fms      , Gs^Fms      , Gs^Fms      , Gd          , Re          , Wwf         , Gg          , Gg          , Gg          , Gs^Fms      , Gs^Fms      , Gs^Fms      , Ww          , Ww          , Ww          , Ww          , Ww          , Gg          , Rp          , Ww          , Rp          , Ww^Bw\r     , Ww          , Hh          , Gs^Fds      , Hh          , Mm          , Mm          , Hh          , Rp          , Rb          , Gll^Fmf     , Gs^Fms      , Mm          , Hh^Fp       
Gg          , Gs^Fms      , Rb          , Gll         , Rb          , Rb          , Gs^Fms      , Gs^Fms      , Re          , Gs^Fms      , Re          , Re          , Gg          , Gg          , Wwg         , Wwg         , Ss          , Ss          , Ss          , Gs^Fms      , Gg^Efm      , Gg^Efm      , Gg^Efm      , Gs^Fms      , Gs^Fms      , Ww          , Ww          , Ww          , Gs          , Ww          , Gg          , Rp          , Gs          , Gg          , Gs          , Hh^Wm       , Gg          , Gs          , Rp          , Gll^Fmf     , Gs^Fds      , Mm          , Hh^Fds      , Mm          
Rb          , Gg          , Rb          , Gs^Fms      , Gs^Fms      , Gs^Fms      , Gs^Fms      , Gs^Fms      , Gg          , Re          , Gg          , Wwg         , Wwg         , Wwg         , Ss          , Sm          , Sm          , Sm          , Rd          , Ss          , Gs          , Gg^Efm      , Gg          , Gs^Fms      , Wwrg        , Ww          , Ww          , Gg^Fet      , Wwrg        , Gs          , Gs^Fds      , Rp          , Rp          , Re          , Rp          , Gs^Fds      , Re          , Gs^Fds      , Rp          , Gs^Fds      , Gs^Fds      , Hh^Fds      , Hh          , Hh^Fds      
Gg          , Rb          , Gg          , Gs^Fms      , Gg          , Gg          , Ww          , Gg          , Gg          , Gg          , Ss          , Ww          , Ss          , Sm          , Ww          , Ss          , Ss          , Ss          , Ss          , Wwf         , Wwg         , Gs          , Gs^Fms      , Wwf         , Wwg         , Wo          , Wo          , Ww          , Ww          , Ds          , Ds          , Gg          , Gs^Fms      , Gs          , Gs^Fds      , Re          , Gs^Fms      , Re          , Rp          , Gll         , Gs^Fds      , Gs^Fds      , Gs^Fds      , Gll         
Gg          , Gs^Fms      , Gg          , Gs^Fms      , Gs^Fms      , Gg          , Wwf         , Wwg         , Wwrg        , Ww          , Wwf         , Sm          , Ss          , Ss          , Sm          , Ss          , Ss          , Ww^Ewl      , Ww^Ewf      , Wwr         , Gs^Fms      , Gs          , Ww          , Wwg         , Wwg         , Wo          , Wo          , Ww          , Wwrg        , Wwrg        , Ds          , Gg          , Gs^Fds      , Gs          , Gs^Fds      , Gs^Fds      , Gs^Fds      , Gs^Fds      , Re          , Re          , Gll^Fp      , Gs^Fds      , Hh^Fds      , Hh^Fds      
Gs          , Gg          , Gg          , Gg          , Gg          , Ww          , Ss          , Ss          , Ss          , Ss          , Ss          , Sm          , Wwf         , Wwrg        , Wwrg        , Ss          , Wwrg        , Ww^Ewf      , Wo          , Ww^Ewf      , Wwr         , Gs          , Ww          , Wo          , Wo          , Wo          , Wo          , Ww          , Ds          , Ds          , Ds          , Gs^Fds      , Gs^Fms      , Gs^Fms      , Hh^Fds      , Hh^Fds      , Gs^Fds      , Gs^Fds      , Re          , Gs^Fds      , Gs^Fds      , Gs^Fds      , Gs^Fds      , Hh^Fds      
Gs          , Gs          , Gg          , Gs^Fms      , Gs^Fms      , Ss          , Sm          , Sm          , Wwf         , Wwf         , Wwf         , Ss          , Ss          , Ss          , Ss          , Sm          , Sm          , Wo          , Wo          , Wo          , Wo          , Ww          , Wwg         , Wo          , Ww          , Ww          , Wo          , Wo          , Wo          , Wwr         , Ds          , Gs^Fds      , Gs^Fds      , Gs^Fms      , Gs          , Hh^Fms      , Re          , Re          , Gg          , Gs^Fds      , Gs^Fds      , Gs^Fms      , Gg          , Gll         
Hh^Fp       , Hh^Fp       , Gg          , Gs^Fms      , Ww          , Wwrg        , Ww          , Ss          , Ww          , Ss          , Sm          , Sm          , Ss          , Ss          , Ss          , Ww          , Ww          , Wo          , Ww          , Wo          , Wo          , Wwg         , Gg^Fet      , Ww          , Ww          , Gs          , Gg^Efm      , Wo          , Wo          , Wwr         , Wwr         , Ds          , Gs^Fds      , Hh^Fms      , Hh^Fms      , Gs^Fds      , Re          , Gs^Fds      , Gs^Fds      , Gs^Fds      , Gs          , Gg          , Gg          , Gs^Fms      
Gs^Fms      , Gg          , Gg          , Gs          , Gs^Fms      , Ss          , Wwg         , Ww          , Ww          , Ww          , Wwf         , Sm          , Ss          , Ss          , Ww          , Sm          , Sm          , Ss          , Ss          , Wwrg        , Wo          , Gs          , Gs^Fms      , Ww          , Gs^Fms      , Gg^Efm      , Wo          , Wo          , Wo          , Ww          , Ww          , Ds          , Ds          , Gg          , Gs          , Gs^Fds      , Re          , Gs          , Re          , Gs^Fds      , Gg          , Gs^Fds      , Gs^Fds      , Gg          
Gs^Fms      , Hh^Fp       , Gg          , Gg          , Gs^Fms      , Gs^Fms      , Wwg         , Ss          , Gs^Fms      , Wwg         , Wwf         , Wwf         , Wwf         , Wwf         , Wwf         , Wwf         , Ss          , Ss          , Wwrg        , Wo          , Wot         , Wo          , Wo          , Wo          , Wo          , Gs^Fms      , Wo          , Wo          , Wo          , Ww          , Ww          , Wwr         , Ds          , Gs^Fds      , Hh^Fds      , Gs^Fds      , Gg          , Re          , Gs^Fds      , Re          , Re          , Rb          , Re          , Gs^Fms      
Gs^Fms      , Gs^Fms      , Gs^Fms      , Gg          , Gg          , Gs^Fms      , Gs^Fms      , Gs^Fms      , Gs^Fms      , Gs^Fms      , Wwg         , Gs^Fms      , Gs^Fms      , Wwf         , Ww          , Ww          , Ww          , Gs^Fms      , Gs^Fms      , Wwrg        , Wo          , Wot         , Wo          , Wo          , Wo          , Wo          , Wo          , Wo          , Wo          , Wo          , Ds          , Ds          , Gs^Fds      , Gs^Fds      , Hh^Fds      , Gll^Fp      , Gg          , Gll^Fp      , Gll^Fp      , Hh^Fds      , Gs^Fds      , Hh^Fms      , Hh^Fds      , Re          
