border_size=1
usage=map

Mm          , Mm          , Mm          , Mm          , Mm          , Gg          , Gg          , Gg          , Ww          , Gg          , Hh^Fms      , Hh^Fms      , Hh^Fms      , Hh^Fmw      , Hh^Fmw      , Hh^Fmw      , Hh^Fmw      , Hh^Fmw      , Uu          , Uu          , Qxu         , Qxu         , Qxu         , Qxu         , Qxu         , Qxu         
Mm          , 1 Kh        , Ch          , Ch          , Rd          , Hh^Vhh      , Gg          , Ww          , Ww          , Hh^Fms      , Ggf         , Hh^Fms      , Hh^Fms      , Hh^Fms      , Hh^Fms      , Hh^Fmw      , Hh          , Uu^Uf       , Uu          , Uu          , Qxu^Bs/     , Co          , Co          , 2 Ko        , Co          , Qxu         
Mm          , Ch          , Mm^Xm       , Mm^Xm       , Gs^Vht      , Rd          , Rd          , Gg          , Ggf         , Gg^Wm       , Ggf         , Gg          , Hh^Fms      , Mm          , Mm          , Hh^Fmw      , Ur          , Hh^Vhh      , Ur          , Ur          , Mm          , Qxu         , Qxu         , Qxu         , Qxu^Bs|     , Qxu         
Gs^Fms      , Rd          , Gg^Ve       , Mm          , Mm          , Gg          , Hh^Fp       , Rd          , Rd          , Rd          , Rd          , Rd          , Rd          , Rd          , Rd          , Rd          , Gg          , Ur          , Gg          , Gg          , Uh          , Mm^Vhh      , Uu          , Qxu         , Uu          , Uu          
Gs^Fms      , Rd          , Rd          , Hh^Fds      , Gs^Fms      , Hh^Fdw      , Mm          , Gs          , Gs          , Gs          , Gs          , Gg          , Mm^Vhh      , Gg          , Rd          , Rd          , Gg^Fet      , Ggf         , Ggf         , Mm          , Mm          , Mm          , Uu          , Uu^Vud      , Uu          , Uu          
Gs^Fms      , Gs^Fms      , Gs^Fms      , Rd          , Gs^Fp       , Hh^Fmf      , Hh^Fms      , Hh^Fms      , Ggf         , Ggf         , Mm          , Mm          , Mm          , Mm          , Mm          , Rd          , Rd          , Rd          , Hh^Fmw      , Hh^Fmw      , Hh^Fmw      , Uu          , Uu          , Uu          , Uu          , Xu          
Gs^Fms      , Gs^Fms      , Wwr         , Wwf^Bw|     , Wwr         , Ss          , Ggf         , Ggf         , Hh^Fmf      , Ggf         , Mm^Vhh      , Mm          , Mm          , Mm          , Mm          , Gg          , Gg          , Rd          , Hh^Fmw      , Hh^Fmw      , Uh          , Xu          , Xu          , Uu          , Uu^Uf       , Xu          
Ww          , Ww          , Ww          , Wwr^Bw|     , Wwr         , Wwr         , Ww          , Hh^Fmf      , Ss          , Hh^Fds      , Mm          , Mm          , Mm          , Mm^Vhh      , Hh^Fds      , Hh^Fds      , Gg          , Rd          , Rd          , Hh^Fmw      , Uh          , Uh          , Uu          , Uu^Uf       , Uu          , Uu^Uf       
Ww          , Ss          , Rd          , Rd          , Gg^Fet      , Ggf         , Ww          , Ww          , Ww          , Ww          , Hh^Fds      , Mm^Vhh      , Mm          , Mm          , Ww          , Hh^Fp       , Hh^Fms      , Hh^Fms      , Hh^Vhh      , Rd          , Ur          , Ur          , Uu^Uf       , Uu          , Uu          , Uu^Uf       
Ss          , Ss          , Rd          , Ggf         , Ss          , Ww          , Ss          , Ww          , Gg          , Hh^Fds      , Hh^Fds      , Hh^Fds      , Hh^Fds      , Hh^Fmf      , Hh^Fmf      , Ww          , Gg^Fet      , Hh^Fms      , Mm          , Mm          , Xu          , Ur          , Ur          , Uh          , Uu^Vu       , Uu          
Wo          , Ss^Vhs      , Wwf         , Ww          , Ww          , Ss^Vm       , Ss          , Ss          , Gg          , Gs^Fmf      , Gs^Fmf      , Gs^Fmf      , Gs^Fp       , Hh^Fds      , Gg          , Gg          , Gg          , Hh^Fms      , Hh^Fms      , Uu          , Uu          , Xu          , Uu^Vu       , Ur          , Ur          , Xu          
Ss          , Wo          , Wwf         , Wo          , Wo^Bw/      , Ww^Bw/      , Ww^Vm       , Ss          , Hh^Fp       , Gg          , Gg          , Gs^Fp       , Gg          , Gs^Fp       , Rd          , Rd          , Rd          , Rd          , Rd          , Uu          , Ur          , Xu          , Xu          , Xu          , Cud         , Xu          
Ss          , Chw         , 3 Khw       , Chw         , Chw         , Wo          , Wwr         , Gs          , Rd          , Gg          , Rd          , Rd          , Rd          , Rd          , Hh^Fms      , Rd          , Hh^Fms      , Rd          , Gg^Ve       , Ur          , Uu          , Ur          , Cud         , Cud         , 4 Kud       , Xu          
Ss          , Ss          , Ss          , Chw         , Ss          , Wo          , Ss          , Rd          , Hh^Fms      , Hh^Fms      , Hh^Fms      , Hh^Fms      , Hh^Fms      , Hh^Fms      , Hh^Fms      , Hh^Fms      , Hh^Fms      , Hh^Fms      , Hh^Fms      , Uu          , Uu          , Xu          , Xu          , Xu          , Xu          , Xu          
